Есть в html, нет в dict

Нету слова 破冰器 | ['破冰器', '_', 'Ледокол']
Нету слова 维库人的脏话 | ['维库人的脏话', '_', 'Врайкульское оскорбление']
Нету слова 图纸：使命暮钟 | ['图纸：使命暮钟', '_', 'Чертеж: колокол призыва']
Нету слова 专横争斗者的项圈 | ['专横争斗者的项圈', '_', 'Колье господствующего бойца']
Нету слова 垃圾场图纸文件夹 | ['垃圾场图纸文件夹', '_', 'Книга кустарных чертежей']
Нету слова 白煮丝行者之卵 | ['白煮丝行者之卵', '_', 'Яйцо долгонога вкрутую']
Нету слова 图纸：机械兽能量背包 | ['图纸：机械兽能量背包', '_', 'Чертеж: блок питания гориллобота']
Нету слова 食谱：塘鲈蛋糕 | ['食谱：塘鲈蛋糕', '_', 'Рецепт: пироги с толстопузиком']
Нету слова 特里费 | ['特里费', '_', 'Нечистый']
Нету слова 安保之戒 | ['安保之戒', '_', 'Безопасность жизни']
Нету слова 和平守护者长靴 | ['和平守护者长靴', '_', 'Сапоги миротворца']
Нету слова 图纸：敏锐护符 | ['图纸：敏锐护符', '_', 'Чертеж: подвеска проворства']
Нету слова 食谱：炸面包圈 | ['食谱：炸面包圈', '_', 'Рецепт: троллебяка']
Нету слова 食谱：菊花茶 | ['食谱：菊花茶', '_', 'Рецепт: скорополоховый чай']
Нету слова 妖术书：掠食龙 | ['妖术书：掠食龙', '_', 'Книга сглаза: компсогнат']
Нету слова 食谱：鳄鱼浓汤 | ['食谱：鳄鱼浓汤', '_', 'Рецепт: суп из кроколиска']
Нету слова 作战魔像蓝图 | ['作战魔像蓝图', '_', 'Чертежи боевого голема']
Нету слова 阿耳忒弥德的奖励 | ['阿耳忒弥德的奖励', '_', 'Награда Артемеды']
Нету слова 好战争斗者的挫败之触 | ['好战争斗者的挫败之触', '_', 'Касание поражения воинственного бойца']
Нету слова 装备图纸：舱底水泵 | ['装备图纸：舱底水泵', '_', 'Чертеж оборудования: трюмная помпа']
Нету слова 食谱：红肉盛宴 | ['食谱：红肉盛宴', '_', 'Рецепт: кровавый пир']
Нету слова 戈尔隆德烤肉 | ['戈尔隆德烤肉', '_', 'Жареный горгрондский сюрприз']
Нету слова 鸦人占卜魔杖 | ['鸦人占卜魔杖', '_', 'Араккоанский пророческий жезл']
Нету слова 次级秘法魔杖 | ['次级秘法魔杖', '_', 'Малый таинственный жезл']
Нету слова 食谱：烤熊排 | ['食谱：烤熊排', '_', 'Рецепт: большой медвежий стейк']
Нету слова 装备图纸：储备弹药 | ['装备图纸：储备弹药', '_', 'Чертеж оборудования: большой боезапас']
Нету слова 食谱：炒科多肉 | ['食谱：炒科多肉', '_', 'Рецепт: жареное мясо кодо']
Нету слова 食谱：龙鳞鱼片 | ['食谱：龙鳞鱼片', '_', 'Рецепт: филе дракоперой рыбы-ангела']
Нету слова 食谱：苏拉玛奢华大餐 | ['食谱：苏拉玛奢华大餐', '_', 'Рецепт: щедрое сурамарское угощение']
Нету слова 微光飞蛾护腕 | ['微光飞蛾护腕', '_', 'Сияющие манжеты мотылька']
Нету слова 图纸：应急火箭鸡 | ['图纸：应急火箭鸡', '_', 'Чертеж: аварийный турбоцыпленок']
Нету слова 用掉一半的仪式粉笔 | ['用掉一半的仪式粉笔', '_', 'Исписанный ритуальный мелок']
Нету слова 徽记之戒 | ['徽记之戒', '_', 'Кольцо черепа']
Нету слова 图纸：完美同步的差速齿轮 | ['图纸：完美同步的差速齿轮', '_', 'Чертеж: идеально синхронизированный дифференциал']
Нету слова 希尔斯布莱德破损指套 | ['希尔斯布莱德破损指套', '_', 'Культи Хилсбрада']
Нету слова 安西亚之戒 | ['安西亚之戒', '_', 'Кольцо антии']
Нету слова 希尔瓦娜斯·风行者的信 | ['希尔瓦娜斯·风行者的信', '_', 'Письмо от Сильваны Ветрокрылой']
Нету слова 食谱：追踪快餐 | ['食谱：追踪快餐', '_', 'Рецепт: завтрак следопыта']
Нету слова 发狂的尸体 | ['发狂的尸体', '_', 'Лихорадочный труп']
Нету слова 食谱：水煮蓝鱼 | ['食谱：水煮蓝鱼', '_', 'Рецепт: вареный луфарь']
Нету слова 橡木槌 | ['橡木槌', '_', 'Дубовая киянка']
Нету слова 黛丝瑞的华美护腿 | ['黛丝瑞的华美护腿', '_', 'Стремительные поножи Дезиры']
Нету слова 书卷：畏缩 | ['书卷：畏缩', '_', 'Книга Сжатия']
Нету слова 食谱：鲜血大餐 | ['食谱：鲜血大餐', '_', 'Рецепт: кровяной пир']
Нету слова 光明使者的璀璨手甲 | ['光明使者的璀璨手甲', '_', 'Сияющие рукавицы Светоносного']
Нету слова ....追踪道标 | ['....追踪道标', '_', 'Отслеживающий маяк БОЛТа']
Нету слова 女儿之手 | ['女儿之手', '_', 'Руки дочери']
Нету слова 食谱：烧烤裂蹄牛 | ['食谱：烧烤裂蹄牛', '_', 'Рецепт: жареное мясо копытня']
Нету слова 霍巴特的备用毂盖 | ['霍巴特的备用毂盖', '_', 'Запасная покрышка Хобарта']
Нету слова 专横争斗者的项链 | ['专横争斗者的项链', '_', 'Ожерелье господствующего бойца']
Нету слова 专横争斗者的战斗披风 | ['专横争斗者的战斗披风', '_', 'Плащ битвы господствующего бойца']
Нету слова 食谱：烹炒大餐 | ['食谱：烹炒大餐', '_', 'Рецепт: угощение вок']
Нету слова 北伐军的公正之触 | ['北伐军的公正之触', '_', 'Благое касание рыцаря']
Нету слова 有标记的无瑕战斗石 | ['有标记的无瑕战斗石', '_', 'Помеченный безупречный камень битв']
Нету слова 食谱：炸鱼 | ['食谱：炸鱼', '_', 'Рецепт: жареная рыбка']
Нету слова 食谱：烟熏鲑鱼 | ['食谱：烟熏鲑鱼', '_', 'Рецепт: копченая форель']
Нету слова 食谱：焰灵鲑鱼 | ['食谱：焰灵鲑鱼', '_', 'Рецепт: лосось духов огня']
Нету слова 石化的黢黑之鳞 | ['石化的黢黑之鳞', '_', 'Окаменевшая черная чешуйка']
Нету слова 食谱：夜之子小食拼盘 | ['食谱：夜之子小食拼盘', '_', 'Рецепт: деликатесное угощение ночнорожденных']
Нету слова 妖术书：蛇 | ['妖术书：蛇', '_', 'Книга сглаза: змея']
Нету слова 食谱：芝士焗鳄鱼 | ['食谱：芝士焗鳄鱼', '_', 'Рецепт: кроколиск о-гратен']
Нету слова yyds | ['yyds', '_', '1) см. 永远滴神\n2) вечно одинокий (永远单身)']
Нету слова 专横争斗者的戒指 | ['专横争斗者的戒指', '_', 'Кольцо господствующего бойца']
Нету слова 罐子里会说话的青蛙 | ['罐子里会说话的青蛙', '_', 'Говорящая лягушка в банке']
Нету слова 折喙鸟大餐 | ['折喙鸟大餐', '_', 'Сюрприз клюволома']
Нету слова 和平守护之刃 | ['和平守护之刃', '_', 'Клинок миротворца']
Нету слова 光明使者的璀璨之冠 | ['光明使者的璀璨之冠', '_', 'Сияющая корона Светоносного']
Нету слова 专横争斗者的徽戒 | ['专横争斗者的徽戒', '_', 'Печатка господствующего бойца']
Нету слова 图纸：绿色喷洒机器人 | ['图纸：绿色喷洒机器人', '_', 'Чертеж: зеленый поливайбот']
Нету слова 袋装青蛙 | ['袋装青蛙', '_', 'Лягушка в мешке']
Нету слова 扎手的夏斯卡格草 | ['扎手的夏斯卡格草', '_', 'Ветвистый фьярнскаггл']
Нету слова 食谱：悼念糕饼 | ['食谱：悼念糕饼', '_', 'Рецепт: поминальный хлеб']
Нету слова 铭焰匕首 | ['铭焰匕首', '_', 'Помеченный огнем кинжал']
Нету слова 食谱：卓格巴尔风味鲑鱼 | ['食谱：卓格巴尔风味鲑鱼', '_', 'Рецепт: лосось по-дрогбарски']
Нету слова 祖尔法拉克铁锣 | ['祖尔法拉克铁锣', '_', 'Гонг ЗулФаррака']
Нету слова 要塞图纸：兵营 | ['要塞图纸：兵营', '_', 'Чертежи гарнизона: казармы']
Нету слова 塔纳安血橙 | ['塔纳安血橙', '_', 'Танаанский кровавый апельсин']
Нету слова 艾瓦诺尔的牢笼 | ['艾瓦诺尔的牢笼', '_', 'Тюрьма Эванор']
Нету слова 窃贼的奖励 | ['窃贼的奖励', '_', 'Награда жулика']
Нету слова 部落奖励宝箱 | ['部落奖励宝箱', '_', 'Сундук с наградой Орды']
Нету слова ”你的祖先“ | ['”你的祖先“', '_', '"Твои предки"']
Нету слова 联盟奖励宝箱 | ['联盟奖励宝箱', '_', 'Сундук с наградой Альянса']
Нету слова 神秘海岛 | ['神秘海岛', '_', 'Неизведанный остров']
Нету слова 祖尔法拉克 | ['祖尔法拉克', '_', 'ЗулФаррак']
Нету слова 不稳定的龙鹰 | ['不稳定的龙鹰', '_', 'Нестабильный дракондор']
Нету слова 希尔瓦娜斯·风行者 | ['希尔瓦娜斯·风行者', '_', 'Леди Сильвана Ветрокрылая']
Нету слова 被捕获的沼泽虎 | ['被捕获的沼泽虎', '_', 'Пойманный ягуар']
Нету слова 军团感应器：敌意 | ['军团感应器：敌意', '_', 'Антенна Легиона: Злоба']
Нету слова 斯库德 | ['斯库德', '_', '"Челюсти"']
Нету слова 维维尔的飞行器 | ['维维尔的飞行器', '_', 'Робот-охранник']
Нету слова 被摧毁的魔能机甲 | ['被摧毁的魔能机甲', '_', 'Разрушенный сквернобот']
Нету слова 蓝色飞蛾 | ['蓝色飞蛾', '_', 'Синий мотылек']
Нету слова 科多兽 | ['科多兽', '_', 'Кодо']
Нету слова 菲尔古 | ['菲尔古', '_', 'Фургу']
Нету слова 厄运战士 | ['厄运战士', '_', 'Помеченный Роком воин']
Нету слова 友好的弗兰克林 | ['友好的弗兰克林', '_', 'Франклин Дружелюбный']
Нету слова 莫多 | ['莫多', '_', 'Мурдо']
Нету слова 军团感应器：湮灭 | ['军团感应器：湮灭', '_', 'Антенна Легиона: Забвение']
Нету слова 奥妮克希亚的精英护卫 | ['奥妮克希亚的精英护卫', '_', 'Элитный охранник Ониксии']
Нету слова 塞拉摩逃亡者 | ['塞拉摩逃亡者', '_', 'Тераморский дезертир']
Нету слова 恶毒导师的影像 | ['恶毒导师的影像', '_', 'Изображение злобного инструктора']
Нету слова 龙鹰 | ['龙鹰', '_', 'Дракондор']
Нету слова 红色飞蛾 | ['红色飞蛾', '_', 'Красный мотылек']
Нету слова 军团感应器：畏惧 | ['军团感应器：畏惧', '_', 'Антенна Легиона: Страх']
Нету слова 拉克托 | ['拉克托', '_', 'Ректор']
Нету слова 大使的荣誉卫士 | ['大使的荣誉卫士', '_', 'Отважный охранник посла']
Нету слова 夏格 | ['夏格', '_', 'Джаг']
Нету слова 军团感应器：暴虐 | ['军团感应器：暴虐', '_', 'Антенна Легиона: Магеддон']
Нету слова 奥克拉 | ['奥克拉', '_', 'Окла']
Нету слова “疯狗”约纳·斯特林 | ['“疯狗”约纳·斯特林', '_', '"Безумный" Иона Стерлинг']
Нету слова 沼泽虎 | ['沼泽虎', '_', 'Болотный ягуар']
Нету слова 库肯 | ['库肯', '_', 'Куркен']
Нету слова 亡者战士 | ['亡者战士', '_', 'Помеченный Смертью воин']
Нету слова 白色飞蛾 | ['白色飞蛾', '_', 'Белый мотылек']
Нету слова 军团感应器：仇恨 | ['军团感应器：仇恨', '_', 'Антенна Легиона: Ненависть']
Нету слова 祖尔法拉克僵尸 | ['祖尔法拉克僵尸', '_', 'Зулфарракский зомби']
Нету слова 莫托尔 | ['莫托尔', '_', 'Молтор']
Нету слова 迪格 | ['迪格', '_', 'Диг']
Нету слова 拉格纳罗斯 | ['拉格纳罗斯', '_', 'Рагнарос']
Нету слова 奥罗 | ['奥罗', '_', 'Оуро']
Нету слова 弗恩·凝眉 | ['弗恩·凝眉', '_', 'Фурл Хмурый Лоб']
Нету слова 黄色飞蛾 | ['黄色飞蛾', '_', 'Желтый мотылек']
Нету слова 勇猛的卫士 | ['勇猛的卫士', '_', 'Охранник-ветеран']
Нету слова 迪菲亚匪徒 | ['迪菲亚匪徒', '_', 'Подручный из братства Справедливости']
Нету слова 唤风者梅恩·长角 | ['唤风者梅恩·长角', '_', 'Призывательница ветров Гордый Рог']
Нету слова 军团感应器：狂乱 | ['军团感应器：狂乱', '_', 'Антенна Легиона: Ярость']
Нету слова 坑道鼠掘地工 | ['坑道鼠掘地工', '_', 'Землекоп-туннельщик']
Нету слова 祖尔法拉克阵亡英雄 | ['祖尔法拉克阵亡英雄', '_', 'Мертвый герой ЗулФаррака']
Нету слова 幽灵面包师 | ['幽灵面包师', '_', 'Бестелесный пекарь']
Нету слова 尼布 | ['尼布', '_', 'Зубастень']
Нету слова 恶毒导师 | ['恶毒导师', '_', 'Злобный инструктор']
Нету слова 档案管理员加尔福特 | ['档案管理员加尔福特', '_', 'Инструктор Галфорд']
Нету слова 鸦人结界 | ['鸦人结界', '_', 'Охранник араккоа']
Нету слова 军团感应器：炼狱 | ['军团感应器：炼狱', '_', 'Антенна Легиона: Геенна']
Нету слова 黑暗战士 | ['黑暗战士', '_', 'Помеченный Тьмой воин']
Нету слова 经验丰富的卫兵 | ['经验丰富的卫兵', '_', 'Опытный охранник']
Нету слова 被摧毁的斥候 | ['被摧毁的斥候', '_', 'Разрушенный часовой']
Нету слова 飞蛾捕捉者 | ['飞蛾捕捉者', '_', 'Ловец шлепокрядов']
Нету слова 骆驼驭手多尔穆斯 | ['骆驼驭手多尔穆斯', '_', 'Дормус Погонщик Верблюдов']
Нету слова 血肉撕裂者诺格加尔 | ['血肉撕裂者诺格加尔', '_', 'Раздиратель Плоти НокГар']
Нету слова 奇维 | ['奇维', '_', 'Жевало']
Нету слова 第二个逃跑的囚犯 | ['第二个逃跑的囚犯', '_', 'Второй сбежавший узник']
Нету слова 乌古特部族成员 | ['乌古特部族成员', '_', 'Дикарь из племени Умгат']
Нету слова 安保官杜尔克 | ['安保官杜尔克', '_', 'Начальник охраны Дирк']
Нету слова 亲切的幽魂 | ['亲切的幽魂', '_', 'Дружелюбный дух']
Нету слова 阿古斯飞蛾 | ['阿古斯飞蛾', '_', 'Аргусский мотылек']
Нету слова 露羽飞蛾 | ['露羽飞蛾', '_', 'Мотылек лую']
Нету слова 莫罗德 | ['莫罗德', '_', 'Мород']
Нету слова 饥饿的监督者 | ['饥饿的监督者', '_', 'Голодный надзиратель']
Нету слова 硬皮抢夺者 | ['硬皮抢夺者', '_', 'Покорный барабанч']
Нету слова 专横的苦力 | ['专横的苦力', '_', 'Зарвавшийся работяга']
Нету слова 黑暗堕落者血骑士 | ['黑暗堕落者血骑士', '_', 'Омраченный рыцарь крови']
Нету слова 镀金飞蛾 | ['镀金飞蛾', '_', 'Золотистый мотылек']
Нету слова 阿莎曼 | ['阿莎曼', '_', 'Пеплошкурая']
Нету слова 楚尔卡 | ['楚尔卡', '_', 'Чарка']
Нету слова 节点领主杜琼·莱德 | ['节点领主杜琼·莱德', '_', 'Повелитель Нексуса Донжон Рейд']
Нету слова 第一个逃跑的囚犯 | ['第一个逃跑的囚犯', '_', 'Первый сбежавший узник']
Нету слова 自然鞭笞者 | ['自然鞭笞者', '_', 'Живой плеточник']
Нету слова 赞达拉血肉撕裂者 | ['赞达拉血肉撕裂者', '_', 'Зандаларский раздиратель плоти']
Нету слова 苏兹 | ['苏兹', '_', 'Сузи']
Нету слова 黑暗堕落者亡刃骑士 | ['黑暗堕落者亡刃骑士', '_', 'Омраченный клинок смерти']
Нету слова 神誓剥皮者 | ['神誓剥皮者', '_', 'Присягнувший свежеватель']
Нету слова 油坑 | ['油坑', '_', 'Нефтяной пруд']
Нету слова 黑暗堕落者顾问 | ['黑暗堕落者顾问', '_', 'Омраченный советник']
Нету слова 织丝者如意 | ['织丝者如意', '_', 'Шелкопряд Жуй']
Нету слова 科里克提克歼灭者 | ['科里克提克歼灭者', '_', 'Криктик-подрывник']
Нету слова 优美的飞蛾 | ['优美的飞蛾', '_', 'Изящный мотылек']
Нету слова 月刃豹 | ['月刃豹', '_', 'Лунный Клык']
Нету слова 战锤大师小布罗林卡 | ['战锤大师小布罗林卡', '_', 'Разоружейник Бролинк-младший']
Нету слова 斯奎 | ['斯奎', '_', 'Вижж']
Нету слова 战锤大师布罗林卡 | ['战锤大师布罗林卡', '_', 'Разоружейник Бролинк']
Нету слова 帕库 | ['帕库', '_', 'Паку']
Нету слова 圆梦双头怪 | ['圆梦双头怪', '_', 'Большой дружелюбный эттин']
Нету слова 穆夫 | ['穆夫', '_', 'Муф']
Нету слова 黑暗堕落者侍女 | ['黑暗堕落者侍女', '_', 'Омраченная-служанка']
Нету слова 迷你小鬼 | ['迷你小鬼', '_', 'Крохотный бесеныш']
Нету слова 死亡浅滩卫士 | ['死亡浅滩卫士', '_', 'Охранник из Мертвецкой Трясины']
Нету слова 天蓝飞蛾 | ['天蓝飞蛾', '_', 'Лазурный мотылек']
Нету слова 着魔的鸦熊 | ['着魔的鸦熊', '_', 'Влюбленный воронух']
Нету слова 拉文凯斯的仆从 | ['拉文凯斯的仆从', '_', 'Слуга Гребня Ворона']
Нету слова 托亚 | ['托亚', '_', 'Тоя']
Нету слова 大法师艾瓦诺尔 | ['大法师艾瓦诺尔', '_', 'Верховный маг Эванор']
Нету слова 船员班农 | ['船员班农', '_', 'Матрос Бэннон']
Нету слова 暴怒飞蛾 | ['暴怒飞蛾', '_', 'Муха Страха']
Нету слова 活泼的幼苗 | ['活泼的幼苗', '_', 'Наглый саженец']
Нету слова 乌佐·唤亡者 | ['乌佐·唤亡者', '_', 'Узо Призыватель Смерти']
Нету слова 影月小飞蛾 | ['影月小飞蛾', '_', 'Маленький мотылек Призрачной Луны']
Нету слова 舞会参与者 | ['舞会参与者', '_', 'Танцовщик']
Нету слова 拉祖姆 | ['拉祖姆', '_', 'Реззун']
Нету слова 索比 | ['索比', '_', 'Гоняш']
Нету слова 碎裂的构造体 | ['碎裂的构造体', '_', 'Разрушенный голем']
Нету слова 虚弱的蹒跚者 | ['虚弱的蹒跚者', '_', 'Ослабевший шаркун']
Нету слова 肌肉虬结的水手 | ['肌肉虬结的水手', '_', 'Дюжий матрос']
Нету слова 花园飞蛾 | ['花园飞蛾', '_', 'Садовый мотылек']
Нету слова 闪光小飞蛾 | ['闪光小飞蛾', '_', 'Сверкающий мотылек']
Нету слова 穆库 | ['穆库', '_', 'Муку']
Нету слова 毫无戒心的骑士 | ['毫无戒心的骑士', '_', 'Беспечный всадник']
Нету слова 骨尘飞蛾 | ['骨尘飞蛾', '_', 'Костокрылый мотылек']
Нету слова 友善的月刃豹 | ['友善的月刃豹', '_', 'Дружелюбный лунопард']
Нету слова 黑暗堕落者贵族 | ['黑暗堕落者贵族', '_', 'Омраченный аристократ']
Нету слова 被污染的鳕鱼 | ['被污染的鳕鱼', '_', 'Больная треска']
Нету слова 仁德会卫兵 | ['仁德会卫兵', '_', 'Охранник ДЭГОЖ']
Нету слова 光点飞蛾 | ['光点飞蛾', '_', 'Сверкающий порхун']
Нету слова 自由的火焰风暴 | ['自由的火焰风暴', '_', 'Необузданный огненный шторм']
Нету слова 熔岩鲸吸者高戈阿克 | ['熔岩鲸吸者高戈阿克', '_', 'Горгак Лавохлеб']
Нету слова 血槌 "补给品" | ['血槌 "补给品"', '_', '"Припасы" Кровавого Молота']
Нету слова 可恶的苦力 | ['可恶的苦力', '_', 'Омерзительный чернорабочий']
Нету слова 剧毒飞蛾 | ['剧毒飞蛾', '_', 'Смертоносный мотылек']
Нету слова 剥皮者金鬃 | ['剥皮者金鬃', '_', 'Златогрив Свежеватель']
Нету слова 谷地飞蛾 | ['谷地飞蛾', '_', 'Долинный порхун']
Нету слова 塔本 | ['塔本', '_', 'Тарбен']
Нету слова 托卢斯 | ['托卢斯', '_', 'Торус']
Нету слова 瑟拉提克 | ['瑟拉提克', '_', 'Шратик']
Нету слова 守护者西波尔克 | ['守护者西波尔克', '_', 'Охранник Ксибек']
Нету слова 奈菲 | ['奈菲', '_', 'Нифи']
Нету слова 霉牙 | ['霉牙', '_', 'Плеснеклык']
Нету слова 瑟拉提克血肉撕裂者 | ['瑟拉提克血肉撕裂者', '_', 'Шратик - раздиратель плоти']
Нету слова 重锤 "戈托" | ['重锤 "戈托"', '_', 'Готу "Молот"']
Нету слова 杀菌炮台 | ['杀菌炮台', '_', 'Очиститель "Бесспорный"']
Нету слова 沾满花粉的工蜂 | ['沾满花粉的工蜂', '_', 'Покрытый пыльцой трутень']
Нету слова 琥珀飞蛾 | ['琥珀飞蛾', '_', 'Янтарный мотылек']
Нету слова 胡拉 | ['胡拉', '_', 'Хура']
Нету слова 塔贝沙 | ['塔贝沙', '_', 'Табита']
Нету слова 真菌飞蛾 | ['真菌飞蛾', '_', 'Грибной мотылек']
Нету слова 乌瑟 | ['乌瑟', '_', 'Слязь']
Нету слова 友好的兽人蛮兵 | ['友好的兽人蛮兵', '_', 'Дружелюбный орк-громила']
Нету слова 被遗忘的饥渴者 | ['被遗忘的饥渴者', '_', 'Забытый жаждущий маны иссохший']
Нету слова 璀璨日光黄晶 | ['璀璨日光黄晶', '_', 'Топаз сияющего солнца']
Нету слова 拉斯普 | ['拉斯普', '_', 'Скреж']
Нету слова 小变异魔丝蛾 | ['小变异魔丝蛾', '_', 'Крохотный мутировавший шелкопряд']
Нету слова 黑暗堕落者达斯·血痕 | ['黑暗堕落者达斯·血痕', '_', 'Омраченный кровопийца']
Нету слова 远望栖地掷斧者 | ['远望栖地掷斧者', '_', 'Метатель топоров из Гнезда']
Нету слова 恐惧织网小蜘蛛 | ['恐惧织网小蜘蛛', '_', 'Страхопряд-охранник']
Нету слова 耶德 | ['耶德', '_', 'Джейд']
Нету слова 黑暗堕落者指挥官 | ['黑暗堕落者指挥官', '_', 'Омраченный командир']
Нету слова 夏洛 | ['夏洛', '_', 'Шало']
Нету слова 雷神剥皮者 | ['雷神剥皮者', '_', 'Шкуродер из клана Громоборцев']
Нету слова 维斯基 | ['维斯基', '_', 'Виизки']
Нету слова 冰魂始祖龙 | ['冰魂始祖龙', '_', 'Рожденный во льдах протодракон']
Нету слова "轮休”的学员 | ['"轮休”的学员', '_', 'Кадет в "увольнении"']
Нету слова 齐格莉德·冰魂 | ['齐格莉德·冰魂', '_', 'Сигрид Дитя Льда']
Нету слова 利森 | ['利森', '_', 'Лесан']
Нету слова 黑暗堕落者大法师 | ['黑暗堕落者大法师', '_', 'Омраченный верховный маг']
Нету слова 温顺的魔犬 | ['温顺的魔犬', '_', 'Покорный ловец Скверны']
Нету слова 奥米 | ['奥米', '_', 'Оме']
Нету слова 农场飞蛾 | ['农场飞蛾', '_', 'Полевой мотылек']
Нету слова 斯维 | ['斯维', '_', 'Сви']
Нету слова 狂怒的冰龙 | ['狂怒的冰龙', '_', 'Мстительный ледяной змей']
Нету слова 齐格莉德·冰魂的始祖幼龙 | ['齐格莉德·冰魂的始祖幼龙', '_', 'Протодракон Сигрид Дитя Льда']
Нету слова 被削弱的监工戴瑟盖斯 | ['被削弱的监工戴瑟盖斯', '_', 'Ослабленный надзиратель Убийственный Взгляд']
Нету слова 颤鸣飞蛾 | ['颤鸣飞蛾', '_', 'Поющий мотылек']
Нету слова 赞奇 | ['赞奇', '_', 'Занчи']
Нету слова 皇家飞蛾 | ['皇家飞蛾', '_', 'Королевский мотылек']
Нету слова 林赛的飞机 | ['林赛的飞机', '_', 'Транспорт Джока']
Нету слова 斑点飞蛾 | ['斑点飞蛾', '_', 'Пятнистый мотылек']
Нету слова 双塔投石手 | ['双塔投石手', '_', 'Подрывник Двух Башен']
Нету слова 黑暗堕落者将领 | ['黑暗堕落者将领', '_', 'Омраченный лейтенант']
Нету слова "闪电" | ['"闪电"', '_', '"Искорка"']
Нету слова 不稳定的紫鳞浮龙 | ['不稳定的紫鳞浮龙', '_', 'Нестабильная лиловая чешуя']
Нету слова 赤红飞蛾 | ['赤红飞蛾', '_', 'Багровый мотылек']
Нету слова 供给官芙蕾 | ['供给官芙蕾', '_', 'Поставщица Фрай']
Нету слова 拉凡 | ['拉凡', '_', 'Рэвиан']
Нету слова 黑色骷髅战马 | ['黑色骷髅战马', '_', 'Черный тяжеловоз-скелет']
Нету слова 蛮项营地打手 | ['蛮项营地打手', '_', 'Подручный Сорвиголов']
Нету слова 幼飞蛾 | ['幼飞蛾', '_', 'Молодой мотылек']
Нету слова 条纹飞蛾 | ['条纹飞蛾', '_', 'Полосатый мотылек']
Нету слова 暴风之盾矿井守卫 | ['暴风之盾矿井守卫', '_', 'Охранник шахты Преграды Ветров']
Нету слова 赞达拉独木舟 | ['赞达拉独木舟', '_', 'Зандаларское каноэ']
Нету слова 冰魂审讯者 | ['冰魂审讯者', '_', 'Хладнокровный дознаватель']
Нету слова 多普 | ['多普', '_', 'Тупень']
Нету слова 苏加 | ['苏加', '_', 'Суджа']
Нету слова 布莱恩·费恩 | ['布莱恩·费恩', '_', 'Брайан Финн']
Нету слова 复仇尖啸者 | ['复仇尖啸者', '_', 'Мстительный визгун']
Нету слова 友好的牦牛人之魂 | ['友好的牦牛人之魂', '_', 'Дружелюбный дух таунка']
Нету слова 裂骨 | ['裂骨', '_', 'Смехокость']
Нету слова 恐慌飞蛾 | ['恐慌飞蛾', '_', 'Объятый ужасом мотылек']
Нету слова 鹰隼大师晨角 | ['鹰隼大师晨角', '_', 'Ловчая Рассветный Рог']
Нету слова 骷髅战马 | ['骷髅战马', '_', 'Боевой конь-скелет']
Нету слова 黑暗堕落者谋士 | ['黑暗堕落者谋士', '_', 'Омраченный тактик']
Нету слова 被削弱的阿瑟里恩 | ['被削弱的阿瑟里恩', '_', 'Ослабленный Эферион']
Нету слова 和平主义者贾鲁克 | ['和平主义者贾鲁克', '_', 'Джалук Мирный']
Нету слова 赞达拉丛林豹战士 | ['赞达拉丛林豹战士', '_', 'Зандаларский воин-ягуар']
Нету слова 贸易执行者 | ['贸易执行者', '_', 'Охранник торговцев']
Нету слова 斯布拉格·轰爆 | ['斯布拉格·轰爆', '_', 'Распор Баззбум']
Нету слова 被侵蚀的道标石 | ['被侵蚀的道标石', '_', 'Разрушенный путевой камень']
Нету слова 纳修 | ['纳修', '_', 'Нашо']
Нету слова 自以为是的弗朗西斯 | ['自以为是的弗朗西斯', '_', 'Фрэнсис Сноб']
Нету слова 狠毒的灭愿者 | ['狠毒的灭愿者', '_', 'Злобный сокрушитель надежды']
Нету слова 友善的鱼人 | ['友善的鱼人', '_', 'Дружелюбный мурлок']
Нету слова 复仇的潜伏者 | ['复仇的潜伏者', '_', 'Мстительный скрытень']
Нету слова 脱水的飞蛾 | ['脱水的飞蛾', '_', 'Иссушенный мотылек']
Нету слова 絮语的血肉兽 | ['絮语的血肉兽', '_', 'Бормочущий мясожор']
Нету слова 强大的飞蛾克星 | ['强大的飞蛾克星', '_', 'Молебой Могучий']
Нету слова 修理工比克希 | ['修理工比克希', '_', 'Толкач Бикси']
Нету слова 巫妖之誓护卫 | ['巫妖之誓护卫', '_', 'Служащий личам охранник']
Нету слова 迷情迅蝶 | ['迷情迅蝶', '_', 'Влюбленный летун']
Нету слова 苏尔诺 | ['苏尔诺', '_', 'Сарнол']
Нету слова 恶毒影魔 | ['恶毒影魔', '_', 'Зловредная тень']
Нету слова 抱起远航图腾 | ['抱起远航图腾', '_', 'Запал тотема мореплавания']
Нету слова 召唤祖尔法拉克僵尸 | ['召唤祖尔法拉克僵尸', '_', 'Оповещение о зулфарракском зомби']
Нету слова 热疫撕咬 | ['热疫撕咬', '_', 'Лихорадочный смертельный укус']
Нету слова 制造祖尔法拉克之槌 | ['制造祖尔法拉克之槌', '_', 'Создание молота ЗулФаррака']
Нету слова 传送：祖阿曼副本 | ['传送：祖阿曼副本', '_', 'Телепортация: специальная область ЗулАман']
Нету слова 大冒险家奖励 | ['大冒险家奖励', '_', 'Награда Главного Путешественника']
Нету слова 法力澎湃 | ['法力澎湃', '_', 'Волнолов маны']
Нету слова 萨德希 | ['萨德希', '_', 'Пенистая лужа']
Нету слова 传送：波特城堡 | ['传送：波特城堡', '_', 'Телепортация: дом Борта']
Нету слова 肢体撕裂者 | ['肢体撕裂者', '_', 'Расчленение']
Нету слова 塔楼攻击奖励 | ['塔楼攻击奖励', '_', 'Повышенный урон по башне']
Нету слова 干扰仪式：教堂广场 | ['干扰仪式：教堂广场', '_', 'Прерывание ритуала: Соборная площадь']
Нету слова 传送门：回音谷 | ['传送门：回音谷', '_', 'Портал в долину Эха']
Нету слова 蓝酒 | ['蓝酒', '_', 'Синее пойло']
Нету слова 传送：祖尔法拉克 | ['传送：祖尔法拉克', '_', 'Телепортация: ЗулФаррак']
Нету слова 碎裂大地的折磨 | ['碎裂大地的折磨', '_', 'Пытка растрескавшейся земли']
Нету слова 心碎的臭臭 | ['心碎的臭臭', '_', 'Разбитое сердце Вонюши']
Нету слова 传送：西部荒野 | ['传送：西部荒野', '_', 'Телепорт в Западный край']
Нету слова 座位可用 | ['座位可用', '_', 'Свободное место']
Нету слова 亡者的哭嚎 | ['亡者的哭嚎', '_', 'Плач мертвых']
Нету слова 干扰仪式：花园 | ['干扰仪式：花园', '_', 'Прерывание ритуала: Парк']
Нету слова 干扰仪式：荣誉谷 | ['干扰仪式：荣誉谷', '_', 'Прерывание ритуала: аллея Чести']
Нету слова 传送：兵营 | ['传送：兵营', '_', 'Телепорт в Казармы']
Нету слова 传送：影踪卫戍营 | ['传送：影踪卫戍营', '_', 'Телепортация: гарнизон Шадо-Пан']
Нету слова 找到僵尸 | ['找到僵尸', '_', 'Найти зомби']
Нету слова 传送到岩石大厅 | ['传送到岩石大厅', '_', 'Телепорт в Чертоги Камня']
Нету слова 否定回答，不正确 | ['否定回答，不正确', '_', 'Ответ "Нет" неверен']
Нету слова 暗影映像 | ['暗影映像', '_', 'Отражение теней']
Нету слова 水桶落地 | ['水桶落地', '_', 'Упавшее ведро']
Нету слова 武器链 | ['武器链', '_', 'Неуязвимость к разоружению']
Нету слова 乌佐的鲜血仪祭 | ['乌佐的鲜血仪祭', '_', 'Кровавый ритуал Узо']
Нету слова 惊恐咆哮 | ['惊恐咆哮', '_', 'Ужасная путаница']
Нету слова 传送：设置返回裂隙 | ['传送：设置返回裂隙', '_', 'Телепортация: возможность возвращения']
Нету слова 炸毁军团感应器 | ['炸毁军团感应器', '_', 'Взрыв антенны Легиона']
Нету слова 孤儿的冰淇淋 | ['孤儿的冰淇淋', '_', 'Мороженое сироты']
Нету слова 干扰仪式：矮人区 | ['干扰仪式：矮人区', '_', 'Прерывание ритуала: квартал дворфов']
Нету слова 黑暗堕落者的契约 | ['黑暗堕落者的契约', '_', 'Пакт Омраченных']
Нету слова 黑暗堕落者的灵气 | ['黑暗堕落者的灵气', '_', 'Присутствие Омраченных']
Нету слова 艾瓦诺尔的牢房锁链 | ['艾瓦诺尔的牢房锁链', '_', 'Тюремные оковы Эванор']
Нету слова 阿卡里的保护 | ['阿卡里的保护', '_', 'Неуязвимость Акали']
Нету слова 撕裂肉体 | ['撕裂肉体', '_', 'Раздирание плоти']
Нету слова 瓦拉塔兹之触 | ['瓦拉塔兹之触', '_', 'Касание Валестраза']
Нету слова 飞蛾振翅 | ['飞蛾振翅', '_', 'Бражники']
Нету слова 传送：达拉然 | ['传送：达拉然', '_', 'Телепортация: Даларан']
Нету слова 强化破甲攻击 | ['强化破甲攻击', '_', 'Улучшенный раскол брони']
Нету слова 肯定回答，正确 | ['肯定回答，正确', '_', 'Ответ "Да" верен']
Нету слова 肯定回答，不正确 | ['肯定回答，不正确', '_', 'Ответ "Да" неверен']
Нету слова 炸毁祖尔法拉克大门 | ['炸毁祖尔法拉克大门', '_', 'Взрыв дверей ЗулФаррака']
Нету слова 干扰仪式：西门 | ['干扰仪式：西门', '_', 'Прерывание ритуала: Западные врата']
Нету слова 练习图纸：装饰汤匙 | ['练习图纸：装饰汤匙', '_', 'Учебный чертеж: декоративные ложки']
Нету слова 超度亡灵 | ['超度亡灵', '_', 'Изгнание нежити']
Нету слова 雷霆顺劈 | ['雷霆顺劈', '_', 'Громовой раскол']
Нету слова 传送：沙塔斯 | ['传送：沙塔斯', '_', 'Телепортация: Шаттрат']
Нету слова 瓦拉塔兹的神圣之触 | ['瓦拉塔兹的神圣之触', '_', 'Божественное касание Валестраза']
Нету слова 洞察真相 | ['洞察真相', '_', 'Вид истины']
Нету слова 踏风连击奖励 | ['踏风连击奖励', '_', 'Неожиданный прием - наложение']
Нету слова 躲闪冲锋 | ['躲闪冲锋', '_', 'Уклонение от рывка']
Нету слова 洛伊的独木舟 | ['洛伊的独木舟', '_', 'Каноэ Луи']
Нету слова 顶点颜色：浅蓝 | ['顶点颜色：浅蓝', '_', 'Цвет вершины: голубой']
Нету слова 合并魔像蓝图 | ['合并魔像蓝图', '_', 'Объединение чертежа голема']
Нету слова 焚烧被毁坏的死尸 | ['焚烧被毁坏的死尸', '_', 'Горящий Разрушенный кадавр']
Нету слова 通往回音谷的传送门 | ['通往回音谷的传送门', '_', 'Портал в Долину Эха']
Нету слова 斩杀被遗忘者囚犯 | ['斩杀被遗忘者囚犯', '_', 'Казнь узника-Отрекшегося']
Нету слова 否定回答，正确 | ['否定回答，正确', '_', 'Ответ "Нет" верен']
Нету слова 致命撕扯 | ['致命撕扯', '_', 'Гибельное кровопускание']
Нету слова 迫击炮干扰 | ['迫击炮干扰', '_', 'Касание мортиры']
Нету слова 浓郁麝牛香 | ['浓郁麝牛香', '_', 'Головокружительный запах']
Нету слова 野蛮撕扯 | ['野蛮撕扯', '_', 'Жестокое кровопускание']
Нету слова 恶毒撕扯 | ['恶毒撕扯', '_', 'Неистовая схватка']
Нету слова 传送：幽暗城 | ['传送：幽暗城', '_', 'Телепортация: Подгород']
Нету слова 干扰仪式：暗巷区 | ['干扰仪式：暗巷区', '_', 'Прерывание ритуала: Волок']
Нету слова 解救布伦希尔达囚犯 | ['解救布伦希尔达囚犯', '_', 'Освободить пленную бруннхильдарку']
Нету слова 传送：藏宝海湾 | ['传送：藏宝海湾', '_', 'Телепортация: Пиратская Бухта']
Нету слова 召唤大法师艾瓦诺尔 | ['召唤大法师艾瓦诺尔', '_', 'Вызов леди Эванор']
Нету слова 设置雕文 | ['设置雕文', '_', 'Яростный раскол']
Нету слова 通灵之触 | ['通灵之触', '_', 'Некротическое касание']
Нету слова 狂乱撕扯 | ['狂乱撕扯', '_', 'Яростное разрывание']
Нету слова 折磨：斯科杜斯之眼 | ['折磨：斯科杜斯之眼', '_', 'Мучение: око Скольда']
Нету слова 传送：传送门守护者哈萨贝尔 | ['传送：传送门守护者哈萨贝尔', '_', 'Телепортация: хранительница порталов Азабель']
Нету слова 传送：神秘海岛 | ['传送：神秘海岛', '_', 'Телепортация: неизведанный остров']
Нету слова 陨落哭嚎 | ['陨落哭嚎', '_', 'Горестный крик']
Нету слова 传送：凋零密院 | ['传送：凋零密院', '_', 'Телепортация: дом Чумы']
Нету слова 粉碎现实 | ['粉碎现实', '_', 'Раскол реальности']
Нету слова 不休不疲 | ['不休不疲', '_', 'Неустанный бег']
Нету слова 被缚的受折磨的灵魂 | ['被缚的受折磨的灵魂', '_', 'Закованная истерзанная душа']
Нету слова 真菌绽放 | ['真菌绽放', '_', 'Плеснецвет']
Нету слова 折磨：莫尔特雷加的残影 | ['折磨：莫尔特雷加的残影', '_', 'Мучение: отголоски Мортрегара']
Нету слова 命运逆位：畏惧死亡 | ['命运逆位：畏惧死亡', '_', 'Инверсия: страх смерти']
Нету слова 已拆除 | ['已拆除', '_', 'Разобрано']
Нету слова 传送：泰洛古斯裂隙 | ['传送：泰洛古斯裂隙', '_', 'Телепортация: Телогрус']
Нету слова 寻忆折磨 | ['寻忆折磨', '_', 'Мучение от извлечения воспоминания']
Нету слова 菲兹兰克航班 | ['菲兹兰克航班', '_', 'Полет Выкрутеня']
Нету слова 食物大战！ | ['食物大战！', '_', 'Бросание едой']
Нету слова 唤风者 | ['唤风者', '_', 'Пробуждение ветра']
Нету слова 精华碎裂 | ['精华碎裂', '_', 'Раскол сущности']
Нету слова 有资格获得奖励 | ['有资格获得奖励', '_', 'Доступны награды']
Нету слова 传送：永恒王宫 | ['传送：永恒王宫', '_', 'Телепортация: Вечный дворец']
Нету слова 疯狂：畏惧死亡 | ['疯狂：畏惧死亡', '_', 'Безумие: страх смерти']
Нету слова 传送：层 | ['传送：层', '_', 'Телепортация: этаж']
Нету слова 致命缠绕 | ['致命缠绕', '_', 'Ужасающий лик смерти']
Нету слова 丧失目标 | ['丧失目标', '_', 'Гиблое дело']
Нету слова 传送：六叠的隐居处 | ['传送：六叠的隐居处', '_', 'Телепортация в прибежище Шестикрата']
Нету слова 传送：萨格拉斯的恶犬 | ['传送：萨格拉斯的恶犬', '_', 'Телепортация: гончие Саргераса']
Нету слова 超级黏黏弹 | ['超级黏黏弹', '_', 'Очень липкая гадость']
Нету слова 献上让人厌恶的深渊精华 | ['献上让人厌恶的深渊精华', '_', 'Преподнести гнусное порождение']
Нету слова 传送：恩佐斯的神思 | ['传送：恩佐斯的神思', '_', 'Телепортация: разум НЗота']
Нету слова 黑暗堕落者之拥 | ['黑暗堕落者之拥', '_', 'Хватка Омраченных']
Нету слова 传送：赛芙·伊文的密室 | ['传送：赛芙·伊文的密室', '_', 'Телепортация: убежище Сеф Ивен']
Нету слова 灵巧躲闪 | ['灵巧躲闪', '_', 'Хитрое уклонение']
Нету слова 璀璨火花易伤 | ['璀璨火花易伤', '_', 'Уязвимость от сияющей искры']
Нету слова 吵闹的 | ['吵闹的', '_', 'Гребля']
Нету слова 碎裂大地 | ['碎裂大地', '_', 'Расщепленная земля']
Нету слова 巨魔之护 | ['巨魔之护', '_', 'Тролль-охранник']
Нету слова 灌注：智力 | ['灌注：智力', '_', 'Усиление: интеллект']
Нету слова 恐惧之跃 | ['恐惧之跃', '_', 'Ужасающий прыжок']
Нету слова 巨魔独木舟 | ['巨魔独木舟', '_', 'Тролльское каноэ']
Нету слова 传送：兵主之座 | ['传送：兵主之座', '_', 'Телепортация к Престолу Примаса']
Нету слова 专横射线 | ['专横射线', '_', 'Деспотический луч']
Нету слова 折磨：魂铸热能 | ['折磨：魂铸热能', '_', 'Мучение: жар Кузни душ']
Нету слова 传送：先知斯基特拉 | ['传送：先知斯基特拉', '_', 'Телепортация: пророк Скитра']
Нету слова 传送：下层 | ['传送：下层', '_', 'Телепортация: нижний уровень']
Нету слова 璀璨火花 | ['璀璨火花', '_', 'Сияющая искра']
Нету слова 暗影分身 | ['暗影分身', '_', 'Темный раскол']
Нету слова 利爪撕扯 | ['利爪撕扯', '_', 'Раздирание когтями']
Нету слова 传送：泽克沃兹 | ['传送：泽克沃兹', '_', 'Телепортация: Зеквоз']
Нету слова 传送：伯拉勒斯 | ['传送：伯拉勒斯', '_', 'Телепортация: Боралус']
Нету слова 折磨：上层区域之力 | ['折磨：上层区域之力', '_', 'Мучение: сила Верхнего яруса']
Нету слова 寰宇爆发 | ['寰宇爆发', '_', 'Необузданный космос']
Нету слова 恶毒暗影 | ['恶毒暗影', '_', 'Зловещие тени']
Нету слова 传送：虚无者莱登 | ['传送：虚无者莱登', '_', 'Телепортация: Ра-ден Отчаявшийся']
Нету слова 传送：上层 | ['传送：上层', '_', 'Телепортация: верхний уровень']
Нету слова 传送到碎石码头 | ['传送到碎石码头', '_', 'Телепортация в Старокаменную гавань']
Нету слова 正在调查 | ['正在调查', '_', 'Расследование']
Нету слова 传送：主宰者要塞 | ['传送：主宰者要塞', '_', 'Телепортация в крепость Владыки']
Нету слова 被诅咒的硬币监狱 | ['被诅咒的硬币监狱', '_', 'Тюрьма проклятой монеты']
Нету слова 初级妖术：细颚龙 | ['初级妖术：细颚龙', '_', 'Простой сглаз: саурид']
Нету слова 鲦鱼抽取器——取消 | ['鲦鱼抽取器——取消', '_', 'Рыбосос – отмена']
Нету слова 美味飞蛾 | ['美味飞蛾', '_', 'Вкусный мотылек']
Нету слова 传送：赤红深渊 | ['传送：赤红深渊', '_', 'Телепортация: Кровавые катакомбы']
Нету слова 凇心之息 | ['凇心之息', '_', 'Дыхание Бессердечных']
Нету слова 传送：心之秘室 | ['传送：心之秘室', '_', 'Телепортация: Зал Сердца']
Нету слова 投掷长枪 | ['投掷长枪', '_', 'Бросок пики']
Нету слова 奥术撕扯 | ['奥术撕扯', '_', 'Чародейский разлом']
Нету слова 传送：伤逝剧场 | ['传送：伤逝剧场', '_', 'Телепортация: Театр Боли']
Нету слова 传送：希利苏斯 | ['传送：希利苏斯', '_', 'Телепортация: Силитус']
Нету слова 不谐乐段 | ['不谐乐段', '_', 'Нестройная каденция']
Нету слова 传送：兹洛斯 | ['传送：兹洛斯', '_', 'Телепортация: Фрос']
Нету слова 灌注：智慧 | ['灌注：智慧', '_', 'Усиление: мудрость']
Нету слова 传送：彼界 | ['传送：彼界', '_', 'Телепортация: Та Сторона']
Нету слова 维系阀箱帮 | ['维系阀箱帮', '_', 'Команда Дроссельпыха – поддержание']
Нету слова 菲兹兰克航班取消 | ['菲兹兰克航班取消', '_', 'Отмена полета Выкрутеня']
Нету слова 传送：恩佐斯的外壳 | ['传送：恩佐斯的外壳', '_', 'Телепортация: панцирь НЗота']
Нету слова 召唤飞蛾 | ['召唤飞蛾', '_', 'Призыв мотылька']
Нету слова 石首的挚友奖励 | ['石首的挚友奖励', '_', 'Преимущества дружбы с Камнелбом']
Нету слова 标枪投掷 | ['标枪投掷', '_', 'Бросок дротика']
Нету слова 灭愿者 | ['灭愿者', '_', 'Сокрушитель надежды']
Нету слова 折磨：凇心之息 | ['折磨：凇心之息', '_', 'Мучение: дыхание Бессердечных']
Нету слова 传送：萧湾镇 | ['传送：萧湾镇', '_', 'Телепортация: Листопадная Бухта']
Нету слова 传送：永夜大教堂 | ['传送：永夜大教堂', '_', 'Телепортация: собор Вечной Ночи']
Нету слова 任务接受：孤注一掷 | ['任务接受：孤注一掷', '_', 'Принять задание: Ставки сделаны']
Нету слова 传送：水晶蝎 | ['传送：水晶蝎', '_', 'Телепортация: кристаллический скорпион']
Нету слова 传送：泰安诺 | ['传送：泰安诺', '_', 'Телепортация: Теланор']
Нету слова 传送：乌索尔之巢 | ['传送：乌索尔之巢', '_', 'Вступление: Логово Урсока']
Нету слова 传送：“混混”哈亚坦 | ['传送：“混混”哈亚坦', '_', 'Телепортация: Харджатан Ленивый']
Нету слова 动物伙伴 - 米莎 | ['动物伙伴 - 米莎', '_', 'Питомец – Миша']
Нету слова 传送：菲拉斯 | ['传送：菲拉斯', '_', 'Телепортация: Фералас']
Нету слова 裂体撕扯 | ['裂体撕扯', '_', 'Рассекающее ранение']
Нету слова 传送：尼斯卡拉 | ['传送：尼斯卡拉', '_', 'Телепортация: Нискара']
Нету слова 大领主的复仇战马 | ['大领主的复仇战马', '_', 'Мстительный скакун верховного лорда']
Нету слова 奥术折磨 | ['奥术折磨', '_', 'Чародейское мучение']
Нету слова 传送：乌索克祭坛 | ['传送：乌索克祭坛', '_', 'Телепортация: Святилище Урсока']
Нету слова 传送：永月平台 | ['传送：永月平台', '_', 'Телепортация: терраса Вечной Луны']
Нету слова 传送：主母萨丝琳 | ['传送：主母萨丝琳', '_', 'Телепортация: госпожа Сашжин']
Нету слова 传送：武僧职业大厅 | ['传送：武僧职业大厅', '_', 'Телепортация: Оплот монахов']
Нету слова 宴会装束-顶点 | ['宴会装束-顶点', '_', 'Маскарадный костюм – вершина']
Нету слова 狂怒撕扯 | ['狂怒撕扯', '_', 'Рвать и кромсать']
Нету слова 投掷标志 | ['投掷标志', '_', 'Бросить жетон']
Нету слова 传送：恶魔审判庭 | ['传送：恶魔审判庭', '_', 'Телепортация: демоническая инквизиция']
Нету слова 传送：团队副本入口 | ['传送：团队副本入口', '_', 'Телепортация: начало рейда']
Нету слова 传送：英灵殿 | ['传送：英灵殿', '_', 'Телепортация: Чертоги Доблести']
Нету слова 传送：法兰纳尔 | ['传送：法兰纳尔', '_', 'Телепортация: Фаланаар']
Нету слова 传送：恐惧魔王 | ['传送：恐惧魔王', '_', 'Телепортация: повелитель ужаса']
Нету слова 传送：苏拉玛王宫 | ['传送：苏拉玛王宫', '_', 'Телепортация: дворец Сурамара']
Нету слова 传送：戒卫侍女 | ['传送：戒卫侍女', '_', 'Телепортация: бдительная дева']
Нету слова 暗影映像：恶毒 | ['暗影映像：恶毒', '_', 'Пагубное темное отражение']
Нету слова 清空盗贼宝库任务 | ['清空盗贼宝库任务', '_', 'Очистка задания хранилища разбойника']
Нету слова 传送：海加尔山 | ['传送：海加尔山', '_', 'Телепортация: гора Хиджал']
Нету слова 追随者：陈·风暴烈酒 | ['追随者：陈·风暴烈酒', '_', 'Соратник: Чэнь Буйный Портер']
Нету слова 传送：千针石林 | ['传送：千针石林', '_', 'Телепортация: Тысяча Игл']
Нету слова 传送：法术之刃 | ['传送：法术之刃', '_', 'Телепортация: чародейский клинок']
Нету слова 传送：法罗纳尔 | ['传送：法罗纳尔', '_', 'Телепортация: Фаронаар']
Нету слова 重置奖励目标 | ['重置奖励目标', '_', 'Обнуление дополнительных задач']
Нету слова 友好的魔刃豹 | ['友好的魔刃豹', '_', 'Дружелюбный манапард']
Нету слова 宴会装束：飞蛾 | ['宴会装束：飞蛾', '_', 'Маскарадный костюм – мотылек']
Нету слова 传送：巡游广场 | ['传送：巡游广场', '_', 'Телепортация: парадная территория']
Нету слова 传送：萨格拉斯之墓 | ['传送：萨格拉斯之墓', '_', 'Телепортация: гробница Саргераса']
Нету слова 神秘射线 | ['神秘射线', '_', 'Пророческий луч']
Нету слова 腐化的审讯 | ['腐化的审讯', '_', 'Искаженный допрос']
Нету слова 传送：残月酒馆 | ['传送：残月酒馆', '_', 'Телепортация: "Лунный полумрак"']
Нету слова 传送：沙尔艾兰 | ['传送：沙尔艾兰', '_', 'Телепортация: ШалАран']
Нету слова 阿莎曼的撕扯 | ['阿莎曼的撕扯', '_', 'Раздирающий удар Пеплошкурой']
Нету слова 合成烹饪食谱 | ['合成烹饪食谱', '_', 'Подготовка кулинарного рецепта']
Нету слова 传送：巴拉丁监狱 | ['传送：巴拉丁监狱', '_', 'Телепортация: крепость Барадин']
Нету слова 传送：虚空之光神殿 | ['传送：虚空之光神殿', '_', 'Телепортация: Храм света Пустоты']
Нету слова 水桶掉落 | ['水桶掉落', '_', 'Бросить ведро']
Нету слова 骑乘独木舟 | ['骑乘独木舟', '_', 'Поездка на каноэ']
Нету слова 解锁“毁灭” | ['解锁“毁灭”', '_', 'Добавить мелодию "Раскол"']
Нету слова 传送：茂林岗哨 | ['传送：茂林岗哨', '_', 'Телепортация: Вечное Цветение']
Нету слова 穆兹 | ['穆兹', '_', 'Музи']
Нету слова 痛苦撕扯 | ['痛苦撕扯', '_', 'Мучительное разрывание']
Нету слова 哈拉萨消失 | ['哈拉萨消失', '_', 'Исчезновение Харатхи']
Нету слова 瘆人嚎叫 | ['瘆人嚎叫', '_', 'Леденящий душу вой']
Нету слова 任务：杀死腐化的野兽 | ['任务：杀死腐化的野兽', '_', 'Задание: Упокоение зараженных']
Нету слова 追随者：剥皮者金鬃 | ['追随者：剥皮者金鬃', '_', 'Соратник: Златогрив Свежеватель']
Нету слова 传送：被遗忘者舰队残骸 | ['传送：被遗忘者舰队残骸', '_', 'Телепортация: Останки флота Отрекшихся']
Нету слова 召唤奖励宝箱 | ['召唤奖励宝箱', '_', 'Призыв сундука с наградами']
Нету слова 准备食物 | ['准备食物', '_', 'Готовая еда']
Нету слова 折磨飞弹 | ['折磨飞弹', '_', 'Мучительный заряд']
Нету слова 酸脊毒浆 | ['酸脊毒浆', '_', 'Лужа едкоспина']
Нету слова 索克雷萨之咒 | ['索克雷萨之咒', '_', 'Запасной план Сокретара']
Нету слова 传送：战争之矛 | ['传送：战争之矛', '_', 'Телепортация: Копье Войны']
Нету слова 斧劈 | ['斧劈', '_', 'Взмах топора']
Нету слова 传送：影月墓地 | ['传送：影月墓地', '_', 'Телепортация: некрополь Призрачной Луны']
Нету слова 奖励目标：骨头 | ['奖励目标：骨头', '_', 'Дополнительная задача: кость']
Нету слова 沉淀，我亲爱的。 | ['沉淀，我亲爱的。', '_', 'Сухой остаток']
Нету слова 海拉加尔登陆战：灰色浅滩 | ['海拉加尔登陆战：灰色浅滩', '_', 'Рейд хеларьяров: Серые мели']
Нету слова 奖励目标：击败加隆·落烬 | ['奖励目标：击败加隆·落烬', '_', 'Убить Джерона Углепада']
Нету слова 祖阿曼奖励任务 | ['祖阿曼奖励任务', '_', 'ЗулАман – награда']
Нету слова 奖励目标：击败瑞莱·山倾 | ['奖励目标：击败瑞莱·山倾', '_', 'Убить Рилаю Бушующую Волну']
Нету слова 任务：邪怒 | ['任务：邪怒', '_', 'Задание: ярость Скверны']
Нету слова 紫罗兰监狱奖励任务 | ['紫罗兰监狱奖励任务', '_', 'Аметистовая крепость – награда']
Нету слова 巡逻员：阵亡者的尊严 | ['巡逻员：阵亡者的尊严', '_', 'Тролльский дозор: смертельная усталость']
Нету слова 剃刀高地奖励任务 | ['剃刀高地奖励任务', '_', 'Курганы Иглошкурых – награда']
Нету слова 狩猎课：谷地飞蛾 | ['狩猎课：谷地飞蛾', '_', 'Уроки охоты: долинные порхуны']
Нету слова 次级憎恶 | ['次级憎恶', '_', 'Малая мерзость']
Нету слова 风暴神殿：失落的仪式 | ['风暴神殿：失落的仪式', '_', 'Святилище Штормов: недостающий ритуал']
Нету слова 留神不速之客 | ['留神不速之客', '_', 'Слежка за нарушителями границ']
Нету слова 乌特加德城堡奖励任务 | ['乌特加德城堡奖励任务', '_', 'Крепость Утгард – награда']
Нету слова 雷象训练：暴怒飞蛾 | ['雷象训练：暴怒飞蛾', '_', 'Тренировка элекка: Муха Страха']
Нету слова 任务报告：掩映岩洞 | ['任务报告：掩映岩洞', '_', 'Оперативный отчет: Тайный грот']
Нету слова 祖尔法拉克奖励任务 | ['祖尔法拉克奖励任务', '_', 'Зулфаррак – награда']
Нету слова 征服斗兽场：九死一生 | ['征服斗兽场：九死一生', '_', 'Бойцовская яма: смерть близка']
Нету слова 诺莫瑞根奖励任务 | ['诺莫瑞根奖励任务', '_', 'Гномреган – награда']
Нету слова 拉博追踪任务 | ['拉博追踪任务', '_', 'Слежка для Лха-По']
Нету слова 任务：艾黎的威胁 | ['任务：艾黎的威胁', '_', 'Операция "Угроза с воздуха"']
Нету слова 回到实验室 | ['回到实验室', '_', 'Назад в лабораторию']
Нету слова 奥金顿奖励任务 | ['奥金顿奖励任务', '_', 'Дополнительное задание: Аукиндон']
Нету слова 座狼训练：暴怒飞蛾 | ['座狼训练：暴怒飞蛾', '_', 'Дрессировка волка: Муха Страха']
Нету слова 任务：调查深岩之洲 | ['任务：调查深岩之洲', '_', 'Задание: разведка в Подземье']
Нету слова 复仇军囚犯的标识牌 | ['复仇军囚犯的标识牌', '_', 'Каталог бирок пленников Эфириума']
Нету слова 任务报告：丘冠牧场 | ['任务报告：丘冠牧场', '_', 'Оперативный отчет: Горное пастбище']
Нету слова 鲜血熔炉奖励任务 | ['鲜血熔炉奖励任务', '_', 'Кузня Крови – награда']
Нету слова 奖励目标：熔岩采石场 | ['奖励目标：熔岩采石场', '_', 'Раскаленный карьер']
Нету слова 生态船奖励任务 | ['生态船奖励任务', '_', 'Ботаника – награда']
Нету слова 格瑞姆巴托奖励任务 | ['格瑞姆巴托奖励任务', '_', 'Грим Батол – награда']
Нету слова 通天峰奖励任务 | ['通天峰奖励任务', '_', 'Дополнительное задание: Небесный Путь']
Нету слова 任务：地狱岩床 | ['任务：地狱岩床', '_', 'Задание: Косогор Бездны']
Нету слова 艾卓-尼鲁布奖励任务 | ['艾卓-尼鲁布奖励任务', '_', 'Азжол-Неруб – награда']
Нету слова 沉没的神庙奖励任务 | ['沉没的神庙奖励任务', '_', 'Затонувший храм – награда']
Нету слова 任务报告：深入柳魔 | ['任务报告：深入柳魔', '_', 'Оперативный отчет: в заросли']
Нету слова 起源大厅奖励任务 | ['起源大厅奖励任务', '_', 'Чертоги Созидания – награда']
Нету слова 祖尔格拉布奖励任务 | ['祖尔格拉布奖励任务', '_', 'ЗулГуруб – награда']
Нету слова 冠军的试炼奖励任务 | ['冠军的试炼奖励任务', '_', 'Дополнительное задание: испытание чемпиона']
Нету слова 岩石大厅奖励任务 | ['岩石大厅奖励任务', '_', 'Чертоги Камня – награда']
Нету слова 任务报告：备用材料 | ['任务报告：备用材料', '_', 'Оперативный отчет: запасные части']
Нету слова 净化斯坦索姆奖励任务 | ['净化斯坦索姆奖励任务', '_', 'Очищение Стратхольма – награда']
Нету слова 指挥官斯普林瓦尔奖励任务 | ['指挥官斯普林瓦尔奖励任务', '_', 'Командир Спрингвейл – награда']
Нету слова 死亡矿井奖励任务 | ['死亡矿井奖励任务', '_', 'Мертвые копи – награда']
Нету слова 魔环奖励任务 | ['魔环奖励任务', '_', 'Окулус – награда']
Нету слова 黑暗深渊奖励任务 | ['黑暗深渊奖励任务', '_', 'Непроглядная пучина – награда']
Нету слова 与恶霸抗争 | ['与恶霸抗争', '_', 'Проучить задиру']
Нету слова 监狱奖励任务 | ['监狱奖励任务', '_', 'Тюрьма – награда']
Нету слова 任务：元素外交 | ['任务：元素外交', '_', 'Задание: стихийная дипломатия']
Нету слова 古达克奖励任务 | ['古达克奖励任务', '_', 'Гундрак – награда']
Нету слова 任务：邪怒毁灭 | ['任务：邪怒毁灭', '_', 'Задание: обуздание Ярости Скверны']
Нету слова 塔布羊训练：暴怒飞蛾 | ['塔布羊训练：暴怒飞蛾', '_', 'Тренировка талбука: Муха Страха']
Нету слова 任务：搜索行动 | ['任务：搜索行动', '_', 'Задание: спасательная операция']
Нету слова 永恒之井奖励任务 | ['永恒之井奖励任务', '_', 'Источник Вечности – награда']
Нету слова 飞蛾满屋 | ['飞蛾满屋', '_', 'Нашествие моли']
Нету слова 汤面时间：奖励 | ['汤面时间：奖励', '_', 'Час лапши: бонус']
Нету слова 任务报告：巨擘封印 | ['任务报告：巨擘封印', '_', 'Оперативный отчет: Великая Печать']
Нету слова 神殿废墟 | ['神殿废墟', '_', 'Разрушенный храм']
Нету слова 任务报告：猎泥海湾 | ['任务报告：猎泥海湾', '_', 'Оперативный отчет: Крабья бухта']
Нету слова 亲爱的纳塔莉亚 | ['亲爱的纳塔莉亚', '_', 'Дражайшая Наталия']
Нету слова 王庭的奖励 | ['王庭的奖励', '_', 'Награда Двора']
Нету слова 映像大厅奖励任务 | ['映像大厅奖励任务', '_', 'Залы Отражений – награда']
Нету слова 旋云之巅奖励任务 | ['旋云之巅奖励任务', '_', 'Вершина Смерча – награда']
Нету слова 倒霉一上午 | ['倒霉一上午', '_', 'Мое ужасное утро']
Нету слова 哪个是女巫？ | ['哪个是女巫？', '_', 'Выбирай любую ведьму']
Нету слова 风暴熔炉：暗影圣物 | ['风暴熔炉：暗影圣物', '_', 'Горнило Штормов: темные реликвии']
Нету слова 任务报告：祖尔加废墟 | ['任务报告：祖尔加废墟', '_', 'Оперативный отчет: руины Зулджана']
Нету слова 任务报告：翠绿洞窟 | ['任务报告：翠绿洞窟', '_', 'Оперативный отчет: Зеленая низина']
Нету слова 巨石之核奖励任务 | ['巨石之核奖励任务', '_', 'Каменные Недра – награда']
Нету слова 乌特加德之巅奖励任务 | ['乌特加德之巅奖励任务', '_', 'Вершина Утгард – награда']
Нету слова 蒸汽地窟奖励任务 | ['蒸汽地窟奖励任务', '_', 'Паровое подземелье – награда']
Нету слова 禁魔监狱奖励任务 | ['禁魔监狱奖励任务', '_', 'Аркатрац – награда']
Нету слова 魔枢（奖励目标）奖励任务 | ['魔枢（奖励目标）奖励任务', '_', 'Нексус – Дополнительная задача']
Нету слова 剃刀沼泽奖励任务 | ['剃刀沼泽奖励任务', '_', 'Лабиринты Иглошкурых – награда']
Нету слова 任务报告：狼穴 | ['任务报告：狼穴', '_', 'Оперативный отчет: Волчье логово']
Нету слова 时光之末奖励任务 | ['时光之末奖励任务', '_', 'Конец Времен – награда']
Нету слова 奇怪的要求 | ['奇怪的要求', '_', 'Странная просьба']
Нету слова 魔枢奖励任务 | ['魔枢奖励任务', '_', 'Нексус – награда']
Нету слова 任务报告：丛林护送 | ['任务报告：丛林护送', '_', 'Оперативный отчет: через джунгли']
Нету слова 破碎大厅奖励任务 | ['破碎大厅奖励任务', '_', 'Разрушенные залы – награда']
Нету слова 任务：杀掉兔妖 | ['任务：杀掉兔妖', '_', 'Операция "Отстрел вредителей"']
Нету слова 安保措施 | ['安保措施', '_', 'Безопасное хранение']
Нету слова 裂蹄牛训练：暴怒飞蛾 | ['裂蹄牛训练：暴怒飞蛾', '_', 'Тренировка копытня: Муха Страха']
Нету слова 萨隆矿坑奖励任务 | ['萨隆矿坑奖励任务', '_', 'Яма Сарона – награда']
Нету слова 醒醒，起来，快离开这 | ['醒醒，起来，快离开这', '_', 'Просыпайся и беги']
Нету слова 能源舰奖励任务 | ['能源舰奖励任务', '_', 'Механар – награда']
Нету слова 魔导师平台奖励任务 | ['魔导师平台奖励任务', '_', 'Терраса Магистров – награда']
Нету слова 任务报告：恐龙研究 | ['任务报告：恐龙研究', '_', 'Оперативный отчет: изучение динозавров']
Нету слова 营救艾瓦诺尔 | ['营救艾瓦诺尔', '_', 'Спасение Эванор']
Нету слова 天火降临 | ['天火降临', '_', 'Да разверзнется ад']
Нету слова 在黑暗中寻找光明 | ['在黑暗中寻找光明', '_', 'Освещенный путь во тьме']
Нету слова 琥珀包裹 | ['琥珀包裹', '_', 'Янтарная комнатка']
Нету слова 鲜血仪祭 | ['鲜血仪祭', '_', 'Ритуал крови']
Нету слова 进入祖尔法拉克 | ['进入祖尔法拉克', '_', 'Вглубь ЗулФаррака']
Нету слова 安抚科多兽 | ['安抚科多兽', '_', 'Успокоительное для кодо']
Нету слова 安保措施：启动 | ['安保措施：启动', '_', 'Системы безопасности: активны']
Нету слова 达克萨隆要塞奖励任务 | ['达克萨隆要塞奖励任务', '_', 'Крепость ДракТарон – награда']
Нету слова 潮汐王座奖励任务 | ['潮汐王座奖励任务', '_', 'Трон Приливов – награда']
Нету слова 奴隶围栏奖励任务 | ['奴隶围栏奖励任务', '_', 'Узилище – награда']
Нету слова 我鹿依旧 | ['我鹿依旧', '_', 'Склеить разбитое сердце']
Нету слова 任务报告：秃鹫之巢 | ['任务报告：秃鹫之巢', '_', 'Оперативный отчет: Гнездо стервятника']
Нету слова 女儿的拥抱 | ['女儿的拥抱', '_', 'Объятия дочери']
Нету слова 他们带走了我的父亲 | ['他们带走了我的父亲', '_', 'Они схватили моего отца']
Нету слова 哀嚎洞穴奖励任务 | ['哀嚎洞穴奖励任务', '_', 'Пещеры Стенаний – награда']
Нету слова 沙漠食谱 | ['沙漠食谱', '_', 'Блюдо из червей']
Нету слова 任务报告：阿罗姆之台 | ['任务报告：阿罗姆之台', '_', 'Оперативный отчет: Застава Арома']
Нету слова 黑色沼泽奖励任务 | ['黑色沼泽奖励任务', '_', 'Черные топи – награда']
Нету слова 破除巫术 | ['破除巫术', '_', 'Война с ведьмами']
Нету слова 野猪训练：暴怒飞蛾 | ['野猪训练：暴怒飞蛾', '_', 'Тренировка вепря: Муха Страха']
Нету слова 任务报告：自然的召唤 | ['任务报告：自然的召唤', '_', 'Оперативный отчет: природа зовет']
Нету слова 任务报告：屠杀巨人 | ['任务报告：屠杀巨人', '_', 'Оперативный отчет: истребление великанов']
Нету слова 任务报告：狐人藏身处 | ['任务报告：狐人藏身处', '_', 'Оперативный отчет: убежище вульпер']
Нету слова 钢铁码头奖励任务 | ['钢铁码头奖励任务', '_', 'Дополнительное задание: Железные доки']
Нету слова 灵魂洪炉奖励任务 | ['灵魂洪炉奖励任务', '_', 'Кузня Душ – награда']
Нету слова 短缺物资的奖励 | ['短缺物资的奖励', '_', 'Редкая награда']
Нету слова 任务：暴风城的秘密 | ['任务：暴风城的秘密', '_', 'Миссия: тайны Штормграда']
Нету слова 任务报告：布伦纳丹 | ['任务报告：布伦纳丹', '_', 'Оперативный отчет: Бреннадам']
Нету слова 闪电大厅奖励任务 | ['闪电大厅奖励任务', '_', 'Чертоги Молний – награда']
Нету слова 不碎之心 | ['不碎之心', '_', 'Не разбитое сердце']
Нету слова 被压制 | ['被压制', '_', 'В плену обстоятельств']
Нету слова 塔布羊训练：裂鞭 | ['塔布羊训练：裂鞭', '_', 'Дрессировка талбука: Распарыватель']
Нету слова 奖励目标：蛮兵高地 | ['奖励目标：蛮兵高地', '_', 'Утес Громил']
Нету слова 滑溜溜的小吃 | ['滑溜溜的小吃', '_', 'Скользкая закуска']
Нету слова 幽暗沼泽奖励任务 | ['幽暗沼泽奖励任务', '_', 'Нижетопь – награда']
Нету слова 玛拉迪诺的奖励 | ['玛拉迪诺的奖励', '_', 'Приз Марадино']
Нету слова 甘苦参半的奖励 | ['甘苦参半的奖励', '_', 'Горькая награда']
Нету слова 任务：夺回包裹 | ['任务：夺回包裹', '_', 'Задание: найти сверток']
Нету слова 海拉加尔登陆战：维克特 | ['海拉加尔登陆战：维克特', '_', 'Рейд хеларьяров: Врект']
Нету слова 任务：被遗忘者的情报 | ['任务：被遗忘者的情报', '_', 'Задание: чума Отрекшихся']
Нету слова 飞蛾叛乱 | ['飞蛾叛乱', '_', 'Восстание мотыльков']
Нету слова 奥达曼奖励任务 | ['奥达曼奖励任务', '_', 'Ульдаман – награда']
Нету слова 任务报告：遗失的补给 | ['任务报告：遗失的补给', '_', 'Оперативный отчет: пропавшие припасы']
Нету слова 扼杀在摇篮 | ['扼杀在摇篮', '_', 'Конец нового начала']
Нету слова 暗影迷宫奖励任务 | ['暗影迷宫奖励任务', '_', 'Темный лабиринт – награда']
Нету слова 祖尔格拉布（奖励目标）奖励任务 | ['祖尔格拉布（奖励目标）奖励任务', '_', 'ЗулГуруб – Дополнительная задача']
Нету слова 风暴熔炉（英雄难度） | ['风暴熔炉（英雄难度）', '_', 'Героический режим: Горнило Штормов']
Нету слова 专横精锐 | ['专横精锐', '_', 'Господствующая элита']
Нету слова 联盟英雄：冷酷 | ['联盟英雄：冷酷', '_', 'Беспощадный герой Альянса']
Нету слова 端掉那些炮台！ | ['端掉那些炮台！', '_', 'Уничтожитель пушек']
Нету слова 联盟英雄：惊恶 | ['联盟英雄：惊恶', '_', 'Герой Альянса: зловещий']
Нету слова 学习烹饪食谱 | ['学习烹饪食谱', '_', 'Изучено кулинарных рецептов']
Нету слова 联盟英雄：血仇 | ['联盟英雄：血仇', '_', 'Герой Альянса: мстительный']
Нету слова 联盟英雄：无畏 | ['联盟英雄：无畏', '_', 'Герой Альянса: бесстрашный']
Нету слова 联盟英雄：凶残 | ['联盟英雄：凶残', '_', 'Яростный герой Альянса']
Нету слова 风暴烈酒酿造厂：白银 | ['风暴烈酒酿造厂：白银', '_', 'Хмелеварня Буйных Портеров: серебро']
Нету слова 联盟英雄：罪邪 | ['联盟英雄：罪邪', '_', 'Герой Альянса: отъявленный "исследователь"']
Нету слова 谁说幽灵不闪亮 | ['谁说幽灵不闪亮', '_', 'Призрак освещенный']
Нету слова 联盟英雄：骄矜 | ['联盟英雄：骄矜', '_', 'Герой Альянса: Гордый']
Нету слова 部落英雄 | ['部落英雄', '_', 'Герой Орды']
Нету слова 收藏家：螳螂妖帝国旗帜 | ['收藏家：螳螂妖帝国旗帜', '_', 'Коллекционер: знамена империи богомолов']
Нету слова 联盟英雄：恶孽 | ['联盟英雄：恶孽', '_', 'Герой Альянса: Бездушный']
Нету слова 炸弹超人 | ['炸弹超人', '_', 'Бомбермэн']
Нету слова 孤独的反叛者 | ['孤独的反叛者', '_', 'Бунтарь и одиночка']
Нету слова 我拿钻石，你吃铁锈 | ['我拿钻石，你吃铁锈', '_', 'Бриллианты и ржавчина']
Нету слова 联盟英雄：凶猛 | ['联盟英雄：凶猛', '_', 'Герой Альянса: свирепый']
Нету слова 联盟英雄：悚然 | ['联盟英雄：悚然', '_', 'Ужасающий герой Альянса']
Нету слова 联盟英雄：狂野 | ['联盟英雄：狂野', '_', 'Герой Альянса: дикий']
Нету слова 风暴烈酒酿造厂：黄金 | ['风暴烈酒酿造厂：黄金', '_', 'Хмелеварня Буйных Портеров: золото']
Нету слова 联盟英雄：暴虐 | ['联盟英雄：暴虐', '_', 'Герой Альянса: Деспотичный']
Нету слова 联盟英雄：残虐 | ['联盟英雄：残虐', '_', 'Герой Альянса: жестокий']
Нету слова 联盟英雄：原祖 | ['联盟英雄：原祖', '_', 'Герой Альянса: необузданный']
Нету слова 联盟英雄：恶毒 | ['联盟英雄：恶毒', '_', 'Герой Альянса: Злонравный']
Нету слова 联盟英雄：好战 | ['联盟英雄：好战', '_', 'Герой Альянса: воинственный']
Нету слова 联盟英雄：暴烈 | ['联盟英雄：暴烈', '_', 'Герой Альянса: неудержимый']
Нету слова 挑战模式地下城完成次数 | ['挑战模式地下城完成次数', '_', 'Пройдено в режиме испытаний']
Нету слова 大显身手：维姆·盐心 | ['大显身手：维姆·盐心', '_', 'Опытный боец: Вим Соленодух']
Нету слова 部落英雄：专横 | ['部落英雄：专横', '_', 'Герой Орды: господствующий']
Нету слова 大显身手：奈莉·锐鳍 | ['大显身手：奈莉·锐鳍', '_', 'Опытный боец: Нери Остроерш']
Нету слова 联盟英雄：罪孽 | ['联盟英雄：罪孽', '_', 'Грешный герой Альянса']
Нету слова 风暴烈酒酿造厂：青铜 | ['风暴烈酒酿造厂：青铜', '_', 'Хмелеварня Буйных Портеров: бронза']
Нету слова 联盟英雄：恶魔 | ['联盟英雄：恶魔', '_', 'Герой Альянса: демонический']
Нету слова 联盟英雄：腐化 | ['联盟英雄：腐化', '_', 'Падший герой Альянса']
Нету слова "争霸艾泽拉斯"钥石大师 | ['"争霸艾泽拉斯"钥石大师', '_', 'Мастер ключей']
Нету слова 春节凯尔萨斯 | ['春节凯尔萨斯', '_', 'Лунный Кельтас']
Нету слова 高升春节希尔瓦娜斯 | ['高升春节希尔瓦娜斯', '_', 'Небесная лунная Сильвана']
Нету слова 青玉春节希尔瓦娜斯 | ['青玉春节希尔瓦娜斯', '_', 'Нефритовая лунная Сильвана']
Нету слова 春节希尔瓦娜斯 | ['春节希尔瓦娜斯', '_', 'Лунная Сильвана']
Нету слова 大显身手阿兹乔丹 | ['大显身手阿兹乔丹', '_', 'Звезда Азмоданк']
Нету слова 地狱吼露奇花花 | ['地狱吼露奇花花', '_', 'Лучихуахуа Адских Крикунов']
Нету слова 露奇花花 | ['露奇花花', '_', 'Лучихуахуа']
Нету слова 春节阿尔萨斯灯笼 | ['春节阿尔萨斯灯笼', '_', 'Лунный фонарь Артаса']
Нету слова 春节凯尔萨斯灯笼 | ['春节凯尔萨斯灯笼', '_', 'Лунный фонарь Кельтаса']
Нету слова 春节希尔瓦娜斯灯笼 | ['春节希尔瓦娜斯灯笼', '_', 'Лунный фонарь Сильваны']
Нету слова 南瓜灯拉格纳罗斯 | ['南瓜灯拉格纳罗斯', '_', 'Тыкварос']
Нету слова 大显身手2016冠军旗帜 | ['大显身手2016冠军旗帜', '_', 'Вымпел звезды 2016']
Нету слова 发放额外奖励 | ['发放额外奖励', '_', 'Отдать бонусы']
Нету слова 选择额外奖励 | ['选择额外奖励', '_', 'Избранные бонусы']
Нету слова 获得的部落对战奖励 | ['获得的部落对战奖励', '_', 'Военный бонус']
Нету слова 资源和每日奖励 | ['资源和每日奖励', '_', 'Ресурсы и ежедневные бонусы']
Нету слова 部落特权奖励 | ['部落特权奖励', '_', 'Бонус привилегии']
Нету слова 每日对抗赛奖励 | ['每日对抗赛奖励', '_', 'Ежедневные победы']
Нету слова 胜利之星奖励加成 | ['胜利之星奖励加成', '_', 'Увеличение звездного бонуса']
Нету слова 您获得了奖励 | ['您获得了奖励', '_', 'Вы получили награду']
Нету слова 胜利之星奖励 | ['胜利之星奖励', '_', 'Звездный бонус']
Нету слова 每日胜利之星奖励 | ['每日胜利之星奖励', '_', 'Ежедневные звезды']
Нету слова 查看归还奖励 | ['查看归还奖励', '_', 'Посмотреть награды воссоединения']
Нету слова 放灯可能获得奖励 | ['放灯可能获得奖励', '_', 'Возможные награды']
Нету слова 选择获得的食谱 | ['选择获得的食谱', '_', 'Выбрать полученный рецепт']
Нету слова 破碎的绝岩 | ['破碎的绝岩', '_', 'Разрушенный утёс']
Нету слова 前往领取奖励 | ['前往领取奖励', '_', 'Получить награды']
Нету слова 璀璨原钻 | ['璀璨原钻', '_', 'Драгоценный бриллиант']
Нету слова 归离城墟 | ['归离城墟', '_', 'Забытый город Гуйли']
Нету слова 阅读教程奖励 | ['阅读教程奖励', '_', 'Награды за прохождение обучения']
Нету слова 有调查奖励尚未领取 | ['有调查奖励尚未领取', '_', 'Доступны награды экспедиций']
Нету слова 璀璨原钻断片 | ['璀璨原钻断片', '_', 'Фрагмент бриллианта']
Нету слова 追击深渊教团的敌人 | ['追击深渊教团的敌人', '_', 'Поймайте члена ордена Бездны']
Нету слова 消灭来袭的敌人 | ['消灭来袭的敌人', '_', 'Одолейте наступающих врагов']
Нету слова 深境回廊奖励 | ['深境回廊奖励', '_', 'Награды Коридора Бездны']
Нету слова 探索派遣奖励 | ['探索派遣奖励', '_', 'Награды за экспедиции']
Нету слова 寻踪讨伐奖励 | ['寻踪讨伐奖励', '_', 'Награды за заказ']
Нету слова 渊月螺旋奖励 | ['渊月螺旋奖励', '_', 'Награды Лунной Спирали']
Нету слова "已离开任务区域" | ['"已离开任务区域"', '_', 'Уже покинули зону задания']
Нету слова 冒险与探索奖励 | ['冒险与探索奖励', '_', 'Исследование мира и приключения']
Нету слова 璀璨原钻碎屑 | ['璀璨原钻碎屑', '_', 'Осколок бриллианта']
Нету слова 额外奖励说明 | ['额外奖励说明', '_', 'Подробнее о дополнительной награде']
Нету слова 领取归还奖励 | ['领取归还奖励', '_', 'Награды воссоединения']
Нету слова 挑战奖励 | ['挑战奖励', '_', 'Награды испытания']
Нету слова 击败深渊教团的敌人 | ['击败深渊教团的敌人', '_', 'Одолейте мага Бездны']
Нету слова 请选择想要领取的奖励物品 | ['请选择想要领取的奖励物品', '_', 'Выберите желаемый предмет']
Нету слова 蒙德地区探索奖励 | ['蒙德地区探索奖励', '_', 'Исследование Мондштадта']
Нету слова 无可接受的奖励 | ['无可接受的奖励', '_', 'Нет доступных наград']
Нету слова 璀璨原钻块 | ['璀璨原钻块', '_', 'Кусок бриллианта']
Нету слова 璃月地区探索奖励 | ['璃月地区探索奖励', '_', 'Исследование Ли Юэ']
Нету слова 明霄灯进度奖励 | ['明霄灯进度奖励', '_', 'Награды строительства лунного фонаря']
Нету слова 存在可领取的奖励 | ['存在可领取的奖励', '_', 'Доступна награда']
Нету слова 我的收藏 | ['我的收藏', '_', 'Моя коллекция']
Нету слова 通过战斗赢取奖励 | ['通过战斗赢取奖励', '_', 'Сражайтесь за награды']
Нету слова *爬行类的"怒吼"* | ['*爬行类的"怒吼"*', '_', '*рев рептилии*']
Нету слова *风暴轰鸣* | ['*风暴轰鸣*', '_', '*звук шторма*']
Нету слова 暴虐食尸鬼 | ['暴虐食尸鬼', '_', 'Буйный вурдалак']
Нету слова 闪光飞蛾 | ['闪光飞蛾', '_', 'Сверкающий мотылек']
Нету слова 飞蛾之尘 | ['飞蛾之尘', '_', 'Пыльца мотылька']
Нету слова 你们这是自寻死路 | ['你们这是自寻死路', '_', 'Вы не готовы']
Нету слова 艰难决定 | ['艰难决定', '_', 'Непростое решение']
Нету слова 不稳定的邪能能量 | ['不稳定的邪能能量', '_', 'Нестабильная Скверна']
Нету слова 孤胆豪客 | ['孤胆豪客', '_', 'Дерзость и слава']
Нету слова 祖尔法拉克之力 | ['祖尔法拉克之力', '_', 'Мощь ЗулФаррака']
Нету слова 安保魔像 | ['安保魔像', '_', 'Охранный голем']
Нету слова 行贿者钱包 | ['行贿者钱包', '_', 'Кошель со Взяткой']
Нету слова 石像鬼城堡 | ['石像鬼城堡', '_', 'Замок Горгульи']
Нету слова 秽言啸鸣 | ['秽言啸鸣', '_', 'Вопль Дурной Речи']
Нету слова 老年告密客 | ['老年告密客', '_', 'Дряхлый доносчик']
Нету слова 遭缉食尸鬼 | ['遭缉食尸鬼', '_', 'Преследуемый Упырь']
Нету слова 恶毒阴影 | ['恶毒阴影', '_', 'Злобные Тени']
Нету слова 嘘声捣乱人 | ['嘘声捣乱人', '_', 'Шикающий Зануда']
Нету слова 咒语灰灭 | ['咒语灰灭', '_', 'Иссушение Заклинания']
Нету слова 血书诅咒 | ['血书诅咒', '_', 'Проклятие Кровавого Тома']
Нету слова 放肆成长 | ['放肆成长', '_', 'Необузданный Рост']
Нету слова 部族反抗 | ['部族反抗', '_', 'Дерзость Клана']
Нету слова 掐灭咒语 | ['掐灭咒语', '_', 'Затушить Заклинание']
Нету слова 卡恩的时间碎裂 | ['卡恩的时间碎裂', '_', 'Временной Раскол Карна']
Нету слова 拉铎司火轮师 | ['拉铎司火轮师', '_', 'Огненный Акробат Ракдосов']
Нету слова 狂徒嬉戏 | ['狂徒嬉戏', '_', 'Разбойничье Веселье']
Нету слова 薇薇安的猎豹 | ['薇薇安的猎豹', '_', 'Ягуар Вивьен']
Нету слова 不朽见证人 | ['不朽见证人', '_', 'Вечная Свидетельница']
Нету слова 景仰象族 | ['景仰象族', '_', 'Почтенный Локсодон']
Нету слова 争议计划 | ['争议计划', '_', 'Спорный План']
Нету слова 执政监视网 | ['执政监视网', '_', 'Консульская Слежка']
Нету слова 狱雷妖 | ['狱雷妖', '_', 'Адский Громовержец']
Нету слова 乙金憎恨兽 | ['乙金憎恨兽', '_', 'Эфириевая Мерзость']
Нету слова 浪客手套 | ['浪客手套', '_', 'Перчатки Плута']
Нету слова 时间延展 | ['时间延展', '_', 'Тянуть Время']
Нету слова 最好不要对结果抱什么期待 | ['最好不要对结果抱什么期待', '_', 'Снизьте ожидания']
Нету слова 辛勤付出总有回报 | ['辛勤付出总有回报', '_', 'Потрудилась на славу']
Нету слова 帮敌人洗洗车吧 | ['帮敌人洗洗车吧', '_', 'Комната смерти']
Нету слова 安保女将 | ['安保女将', '_', 'Начальник охраны']
Нету слова 总有回报 | ['总有回报', '_', 'Потрудился на славу']
Нету слова 运载目标生命值奖励 | ['运载目标生命值奖励', '_', 'Бонус за сохранность груза']
Нету слова 璀璨光牛 | ['璀璨光牛', '_', 'Мерцающий бык']
Нету слова 这种天气最适合吃糖煎饼啦 | ['这种天气最适合吃糖煎饼啦', '_', 'Не помешал бы хотток']
Нету слова 诡奇反馈护符 | ['诡奇反馈护符', '_', 'Амулет сверхъестественных рефлексов']
Нету слова 诡奇反馈 | ['诡奇反馈', '_', 'Сверхъестественные рефлексы']
Нету слова 最亲爱的德雅拉 | ['最亲爱的德雅拉', '_', 'Милая Диния']
Нету слова 获得石林蓝酒 | ['获得石林蓝酒', '_', 'Добыть Балморскую синь']
Нету слова 石林蓝酒笔记 | ['石林蓝酒笔记', '_', 'Записка о Балморской сини']
Нету слова 白头之约 | ['白头之约', '_', 'Кольцо святости брака']
Нету слова 剥皮者克雷夫 | ['剥皮者克雷夫', '_', 'Крев Шкуродер']
Нету слова 瓶装飞蛾 | ['瓶装飞蛾', '_', 'Мотылек в банке']
Нету слова 放置石林蓝酒 | ['放置石林蓝酒', '_', 'Подкинуть Балморскую синь']
Нету слова 展现你的“无形冲击”龙吼 | ['展现你的“无形冲击”龙吼', '_', 'Продемонстрировать Безжалостную силу']
Нету слова 沙利多的魔法心得奖励 | ['沙利多的魔法心得奖励', '_', 'Работы Шалидора - награда']
Нету слова 询问囚犯们关于迈德纳奇的事情 | ['询问囚犯们关于迈德纳奇的事情', '_', 'Расспросить каторжников о Маданахе']
Нету слова 先祖飞蛾翅膀 | ['先祖飞蛾翅膀', '_', 'Крыло мотылька предка']
Нету слова 先祖飞蛾 | ['先祖飞蛾', '_', 'Мотылек предка']
Нету слова 亲爱的德雅拉 | ['亲爱的德雅拉', '_', 'Милая Диния']
Нету слова 召唤风暴 - 风暴 | ['召唤风暴 - 风暴', '_', 'Грозовой зов - Струн']
Нету слова “剥皮者”克雷夫 | ['“剥皮者”克雷夫', '_', 'Крев Шкуродер']
Нету слова 沙利多的见解奖励 | ['沙利多的见解奖励', '_', 'Работы Шалидора - награда']
Нету слова 辛德莱昂的巧技 | ['辛德莱昂的巧技', '_', 'Сюрприз Синдериона']
Нету слова 萨古拉斯的敌人 | ['萨古拉斯的敌人', '_', 'Участь врагов Шакураса']
Нету слова 强健治愈 | ['强健治愈', '_', 'Под завязку']
Нету слова 环锁囚禁 | ['环锁囚禁', '_', 'Цепная реакция']
Нету слова 说...就... | ['说...就...', 'shuō... jiù ...', 'раз сказал (решил) ..., значит делай ...; ни у кого не спрашивать разрешения']
Нету слова 大迷糊 | ['大迷糊', '_', 'Зануда']
Нету слова 炸弹人 | ['炸弹人', '_', 'Кавардак']
Нету слова 伊维特 | ['伊维特', '_', 'Иветта']
Нету слова 布莉 | ['布莉', '_', 'Бритт']
Нету слова 希利克 | ['希利克', '_', 'Синрик']
Нету слова 特利克 | ['特利克', '_', 'Терек']
Нету слова 哈乔 | ['哈乔', '_', 'Хафьорг']
Нету слова 还是不太像 | ['还是不太像', '_', 'Все равно вряд ли']
Нету слова 友好的邻近公社 | ['友好的邻近公社', '_', 'Дружелюбный сосед-коммунар']
Нету слова 卡拉斯·马佐夫的自杀 | ['卡拉斯·马佐夫的自杀', '_', 'Самоубийство Краса Мазова']
Нету слова 二手制服架子 | ['二手制服架子', '_', 'Вешалка с подержанной униформой']
Нету слова 把缘由抛诸脑后 | ['把缘由抛诸脑后', '_', 'Забудь про здравый смысл']
Нету слова 胖子安格斯 | ['胖子安格斯', '_', 'Жирдяй Ангус']
Нету слова 典当＞ | ['典当＞', '_', 'Заложить＞']
Нету слова 丽耶 | ['丽耶', '_', 'Леа']
Нету слова 载入之前储存的游戏进度 | ['载入之前储存的游戏进度', '_', 'Загрузить сохраненную игру']
Нету слова 希拉德‧费兹奥耶斯泰兰 | ['希拉德‧费兹奥耶斯泰兰', '_', 'Шилярд Фиц-Эстерлен']
Нету слова 投掷向目标 | ['投掷向目标', '_', 'Точные броски']
Нету слова 诅咒物品的工艺蓝图 | ['诅咒物品的工艺蓝图', '_', 'Чертеж проклятого предмета']
Нету слова 贾巴尔‧普利马 | ['贾巴尔‧普利马', '_', 'Юбал Прима']
Нету слова 希拉德‧费兹奥耶斯泰兰的命令 | ['希拉德‧费兹奥耶斯泰兰的命令', '_', 'Приказ Шилярда Фиц-Эстерлена']
Нету слова 友善的狗 | ['友善的狗', '_', 'Дружелюбный пес']
Нету слова 迪沙谬那囚犯的笔记 | ['迪沙谬那囚犯的笔记', '_', 'Записки пленника из Тесхам-Мутны']
Нету слова 倒霉鬼的宝藏 | ['倒霉鬼的宝藏', '_', 'Клад неудачника']
Нету слова 螯虾巧达汤食谱 | ['螯虾巧达汤食谱', '_', 'Рецепт похлебки из раков']
Нету слова 帮会基地＞ | ['帮会基地＞', '_', 'Логово ганзы＞']
Нету слова 酿酒师的委托＞ | ['酿酒师的委托＞', '_', 'Заказ винодела＞']
Нету слова 困扰的流浪骑士＞ | ['困扰的流浪骑士＞', '_', 'Странствующий рыцарь в беде＞']
Нету слова 建造大脚丫＞ | ['建造大脚丫＞', '_', 'По стопам пророка Лебеды＞']
Нету слова ＞ | ['＞', '_', '＞']
Нету слова ＞公国仲裁官 | ['＞公国仲裁官', '_', 'Финансовый посредник княгини']
Нету слова ＞铁匠 | ['＞铁匠', '_', '＞кузнец']
Нету слова 精明腰带 | ['精明腰带', '_', 'Практичный ремень']
Нету слова 友好的巨魔 | ['友好的巨魔', '_', 'Дружелюбный тролль']
Нету слова 改良的魔杖 | ['改良的魔杖', '_', 'Импровизированный жезл']
Нету слова 璀璨的项链 | ['璀璨的项链', '_', 'Сияющее ожерелье']
Нету слова 花园门的钥匙 | ['花园门的钥匙', '_', 'Ключ от ворот в саду']
Нету слова 寒冰肌肤技能书 | ['寒冰肌肤技能书', '_', 'Книга навыка "Ледяная кожа"']
Нету слова 风度翩翩的朱恩 | ['风度翩翩的朱恩', '_', 'Лихая Джун']
Нету слова 新地图 | ['新地图', '_', 'Новая карта']
Нету слова 光滑的浅色裤子 | ['光滑的浅色裤子', '_', 'Узкие легкие брюки']
Нету слова 纳林 | ['纳林', '_', 'Нарин']
Нету слова 破烂的蓝图 | ['破烂的蓝图', '_', 'Потрепанный чертеж']
Нету слова 寒冰肌肤 | ['寒冰肌肤', '_', 'Ледяная кожа']
Нету слова 来自鸡的奖励 | ['来自鸡的奖励', '_', 'Награда курицы']
Нету слова 塔赫 | ['塔赫', '_', 'Тадг']
Нету слова 我是合成人 | ['我是合成人', '_', 'Я синт']
Нету слова 她是合成人 | ['她是合成人', '_', 'Она синт']
Нету слова 她的无线电 | ['她的无线电', '_', 'Ее рация']
Нету слова 或许吧 | ['或许吧', '_', 'Я не знаю']
Нету слова 我不是合成人 | ['我不是合成人', '_', 'Я не синт']
Нету слова 拿去吧 | ['拿去吧', '_', 'Забирайте']
Нету слова 合成人是财产 | ['合成人是财产', '_', 'Синты вещи']
Нету слова 你不是合成人 | ['你不是合成人', '_', 'Ты не синт']
Нету слова 她不是合成人 | ['她不是合成人', '_', 'Она не синт']
Нету слова 合成人的头 | ['合成人的头', '_', 'Голова синта']
Нету слова 合成人只是机器 | ['合成人只是机器', '_', 'Синты машины']
Нету слова 一群合成人 | ['一群合成人', '_', 'Группа синтов']
Нету слова 合成人的朋友 | ['合成人的朋友', '_', 'Я друг синтов']
Нету слова 合成人是块毒瘤 | ['合成人是块毒瘤', '_', 'Синты чудовища']
Нету слова 杀了合成人 | ['杀了合成人', '_', 'Избавься от синта']
Нету слова 我们保护合成人 | ['我们保护合成人', '_', 'Мы защищаем синтов']
Нету слова 自称迪玛的合成人 | ['自称迪玛的合成人', '_', 'Синт по имени ДиМа']
Нету слова 报出合成人编号 | ['报出合成人编号', '_', 'Назвать код синта']
Нету слова 有人鼓励合成人 | ['有人鼓励合成人', '_', 'Кто-то зовет синтов']
Нету слова 名为佳澄的合成人 | ['名为佳澄的合成人', '_', 'Синт по имени Касуми']
Нету слова 找出失踪的合成人 | ['找出失踪的合成人', '_', 'Найти пропавшего синта']
Нету слова 合成人是威胁 | ['合成人是威胁', '_', 'Синты угроза для людей']
Нету слова 失踪合成人的头 | ['失踪合成人的头', '_', 'Голова пропавшего синта']
Нету слова 她还是你的女儿 | ['她还是你的女儿', '_', 'Она по-прежнему ваша дочь']
Нету слова 因为你是合成人 | ['因为你是合成人', '_', 'Что ты на самом деле синт']
Нету слова 对合成人没有意见 | ['对合成人没有意见', '_', 'У меня нет определенного мнения']
Нету слова 西托 | ['西托', '_', 'Цито']
Нету слова 吸血蠕虫 | ['吸血蠕虫', '_', 'Кровочервь']
Нету слова 战狼帮豹盔 | ['战狼帮豹盔', '_', 'Шлем Стаи (ягуар)']
Нету слова 核口可乐博物馆 | ['核口可乐博物馆', '_', 'Музей "Ядер-Колы"?']
Нету слова 吸血幼蠕虫 | ['吸血幼蠕虫', '_', 'Личинка кровочервя']
Нету слова 狠毒吸血蠕虫 | ['狠毒吸血蠕虫', '_', 'Ядовитый кровочервь']
Нету слова 核口核弹头蓝图 | ['核口核弹头蓝图', '_', 'Чертежи "Ядер-Заряда"']
Нету слова 雅座化妆室钥匙 | ['雅座化妆室钥匙', '_', 'Ключ от гримерки в "Салоне"']
Нету слова 狠毒吸血幼蠕虫 | ['狠毒吸血幼蠕虫', '_', 'Личинка ядовитого кровочервя']
Нету слова 战狼帮毛帽鸟面罩 | ['战狼帮毛帽鸟面罩', '_', 'Вязаная шапка Стаи и маска ворона']
Нету слова 不是合成人 | ['不是合成人', '_', 'Не синт']
Нету слова 他是合成人 | ['他是合成人', '_', 'Он синт']
Нету слова 你是合成人 | ['你是合成人', '_', 'Ты синт']
Нету слова 杀死合成人 | ['杀死合成人', '_', 'Убей синта']
Нету слова 我还活着 | ['我还活着', '_', 'Я еще живу']
Нету слова 回收合成人 | ['回收合成人', '_', 'Задержание']
Нету слова 逃走的合成人 | ['逃走的合成人', '_', 'Беглый синт']
Нету слова 我有点怀疑 | ['我有点怀疑', '_', 'Это вряд ли']
Нету слова 合成人是敌人 | ['合成人是敌人', '_', 'Синты враги']
Нету слова 我记得他 | ['我记得他', '_', 'Я его помню']
Нету слова 你这废物 | ['你这废物', '_', 'Ничтожество']
Нету слова 吉妮瓦的办公桌 | ['吉妮瓦的办公桌', '_', 'Стол Женевы']
Нету слова 杀死合成人数 | ['杀死合成人数', '_', 'Синтов убито']
Нету слова 拯救合成人 | ['拯救合成人', '_', 'Спасти синта']
Нету слова 我还是这样觉得 | ['我还是这样觉得', '_', 'Наверное, да']
Нету слова 失去你 | ['失去你', '_', 'Потерять тебя']
Нету слова 叛逃的合成人 | ['叛逃的合成人', '_', 'Синт-мятежник']
Нету слова 合成人不是人类 | ['合成人不是人类', '_', 'Синты не люди']
Нету слова 史塔顿的合成人 | ['史塔顿的合成人', '_', 'Синт Стоктона']
Нету слова 太夸张了 | ['太夸张了', '_', 'Какой-то бред']
Нету слова 吉妮瓦的套装 | ['吉妮瓦的套装', '_', 'Гарнитур Женевы']
Нету слова 杀合成人 | ['杀合成人', '_', 'Убивать синтов?']
Нету слова 讨厌合成人 | ['讨厌合成人', '_', 'Ненавижу синтов']
Нету слова 不是罪犯 | ['不是罪犯', '_', 'Я не преступник']
Нету слова 保护合成人 | ['保护合成人', '_', 'Я защищу синтов']
Нету слова 捕获的合成人 | ['捕获的合成人', '_', 'Захваченный синт']
Нету слова 合成人和学院 | ['合成人和学院', '_', 'Синты и Институт']
Нету слова 左腿骨头 | ['左腿骨头', '_', 'Кости левой ноги']
Нету слова 合成人是机器 | ['合成人是机器', '_', 'Синты это машины']
Нету слова 害怕合成人 | ['害怕合成人', '_', 'Ты боишься синтов']
Нету слова 发现我们 | ['发现我们', '_', 'Как вы нас нашли?']
Нету слова 解放合成人 | ['解放合成人', '_', 'Освободить синтов']
Нету слова 拯救更多合成人 | ['拯救更多合成人', '_', 'Спасти еще синтов']
Нету слова 埋没的工厂 | ['埋没的工厂', '_', 'Разрушенный завод']
Нету слова 全没了 | ['全没了', '_', 'Ничего не осталось']
Нету слова 找到逃走的合成人 | ['找到逃走的合成人', '_', 'Найти беглых синтов']
Нету слова 生产合成人 | ['生产合成人', '_', 'Производство синтов']
Нету слова 不知道合成人的事 | ['不知道合成人的事', '_', 'Я мало знаю о синтах']
Нету слова 询问合成人的事 | ['询问合成人的事', '_', 'Спросить, синт ли он']
Нету слова 去找合成人 | ['去找合成人', '_', 'Поговорить с синтами']
Нету слова 来我这 | ['来我这', '_', 'Присоединяйся ко мне']
Нету слова 有多少合成人逃走 | ['有多少合成人逃走', '_', 'Сколько уже сбежало?']
Нету слова 可能会有危险 | ['可能会有危险', '_', 'Это может быть опасно']
Нету слова 后果不堪设想 | ['后果不堪设想', '_', 'Печальные последствия']
Нету слова 博物馆阳台钥匙 | ['博物馆阳台钥匙', '_', 'Ключ от балкона музея']
Нету слова 我不会妨碍你 | ['我不会妨碍你', '_', 'Постараюсь не мешаться']
Нету слова 反对屠杀合成人 | ['反对屠杀合成人', '_', 'Против геноцида синтов']
Нету слова 合成人护甲头盔 | ['合成人护甲头盔', '_', 'Броня синтов для головы']
Нету слова 大概没用 | ['大概没用', '_', 'Наверняка там ничего нет']
Нету слова 合成人护甲胸部 | ['合成人护甲胸部', '_', 'Броня синтов для туловища']
Нету слова 彼此都帮合成人 | ['彼此都帮合成人', '_', '"Подземка" помогает синтам']
Нету слова 学院合成人回收部 | ['学院合成人回收部', '_', 'Институт бюро робоконтроля']
Нету слова 别逼我 | ['别逼我', '_', 'Я могу развязать тебе язык']
Нету слова 带合成人回家 | ['带合成人回家', '_', 'Мы вернем этого синта домой']
Нету слова 合成人护甲左腿 | ['合成人护甲左腿', '_', 'Броня синтов для левой ноги']
Нету слова 合成人护甲左臂 | ['合成人护甲左臂', '_', 'Броня синтов для левой руки']
Нету слова 已阻挡合成人攻击 | ['已阻挡合成人攻击', '_', 'Удалось отбить атаку синтов']
Нету слова 必须解放合成人 | ['必须解放合成人', '_', 'Синты должны быть свободными']
Нету слова 急流号残骸 | ['急流号残骸', '_', 'Разрушенный корабль "Клокот"']
Нету слова 合成人护甲右臂 | ['合成人护甲右臂', '_', 'Броня синтов для правой руки']
Нету слова 合成人护甲右腿 | ['合成人护甲右腿', '_', 'Броня синтов для правой ноги']
Нету слова 终于遇到合成人 | ['终于遇到合成人', '_', 'Наконец-то мне встретился синт']
Нету слова 查看通缉海报 | ['查看通缉海报', '_', 'Прочитать объявление о розыске']
Нету слова 解救合成人很高尚 | ['解救合成人很高尚', '_', 'Спасение синтов благородное дело']
Нету слова 有点太夸张了 | ['有点太夸张了', '_', 'Не думаю, что они бы этого хотели']
Нету слова 失踪合成人调查 | ['失踪合成人调查', '_', 'Расследование исчезновения синтов']
Нету слова 对付逃走的合成人 | ['对付逃走的合成人', '_', 'Разобраться со сбежавшими синтами']
Нету слова 被贝斯所遗忘 | ['被贝斯所遗忘', '_', 'Забытый Бесом']
Нету слова 鸟豹 | ['鸟豹', '_', 'Госпожа Птица-Ягуар']
Нету слова 达沃维奇 | ['达沃维奇', '_', 'Графиня']
Нету слова 人造资源奖励 | ['人造资源奖励', '_', 'Награды за артефакты']
Нету слова 波兰的 | ['波兰的', '_', 'польск.']
Нету слова 无主题性奖励 | ['无主题性奖励', '_', 'Нет премии.']
Нету слова 劳马河 | ['劳马河', '_', 'Реума']
Нету слова 夫纳尼 | ['夫纳尼', '_', 'Фунани']
Нету слова 尼亚尼 | ['尼亚尼', '_', 'Ньяни']
Нету слова 死之 | ['死之', '_', 'Леди']
Нету слова 已显示 | ['已显示', '_', 'Раскрытая клетка']
Нету слова 月豹 | ['月豹', '_', 'Лунный Ягуар']
Нету слова 考察活动奖励 | ['考察活动奖励', '_', 'Награды за экспедицию']
Нету слова 建造一个城寨 | ['建造一个城寨', '_', 'Построить мотт и бейли']
Нету слова 赫巴 | ['赫巴', '_', 'Хеба']
Нету слова 新加坡的 | ['新加坡的', '_', 'сингапурск.']
Нету слова 选择远古遗迹奖励 | ['选择远古遗迹奖励', '_', 'Выберите бонус древних руин']
Нету слова 斯维亚托 | ['斯维亚托', '_', 'Святослав']
Нету слова 莫德 | ['莫德', '_', 'Мод']
Нету слова 西瓦尔 | ['西瓦尔', '_', 'Сиваль']
Нету слова 信条已被选择 | ['信条已被选择', '_', 'Верование принято']
Нету слова 和平条约已到期 | ['和平条约已到期', '_', 'Истек срок мирного договора']
Нету слова "消隐者" | ['"消隐者"', '_', '"Фантомы"']
Нету слова 伊肯 | ['伊肯', '_', 'Икен']
Нету слова 游击战专家 | ['游击战专家', '_', 'Партизанские навыки']
Нету слова 驻守站奖励 | ['驻守站奖励', '_', 'Награды от станций']
Нету слова 波卡利 | ['波卡利', '_', 'Бокхари']
Нету слова 所有白银级奖励 | ['所有白银级奖励', '_', 'Все награды серебряного уровня']
Нету слова 梅瓦 | ['梅瓦', '_', 'Маева']
Нету слова "格兰特船长的儿女" | ['"格兰特船长的儿女"', 'gēlántè chuánzhǎng de érnǚ', '"Дети капитана Гранта" (роман Жюля Верна)']
Нету слова 洗宿用的东西 | ['洗宿用的东西', 'xǐsù yòng de dōngxī', 'туалетные принадлежности']
Нету слова 德米特里·普罗托波波夫 | ['德米特里·普罗托波波夫', '_', 'Дмитрий Протопопов (1897-1986, первый секретарь ЦК КП Таджикской ССР в 1937-1946 гг.)']
Нету слова "信访条例" | ['"信访条例"', 'xìnfǎng tiáolì', '"Правила приёма и рассмотрения обращений граждан"']
Нету слова 史楚金 | ['史楚金', 'shǐchǔjīn', 'Щукин (фамилия)']
Нету слова "灯蛾"教练机 | ['"灯蛾"教练机', 'dēng’é jiàoliànjī', 'учебно-тренировочный самолёт «Тайгер Мот» (Великобритания)']
Нету слова 好战成瘾 | ['好战成瘾', 'hàozhàn chéngyǐn', 'наркомания войны']
Нету слова 嗷嗷地 | ['嗷嗷地', '_', 'диал. очень']
Нету слова 谢列日金 | ['谢列日金', 'xièlièrìjīn', 'Сережкин (фамилия)']
Нету слова 谢列日金娜 | ['谢列日金娜', 'xièlièrìjīn’nà', 'Сережкина (фамилия)']
Нету слова 膨胀机冷箱 | ['膨胀机冷箱', 'péngzhàngjī lěngxiāng', 'кожух ТДКА, теплоизолирующий блок турбодетандера']
Нету слова 切博塔列夫 | ['切博塔列夫', '_', 'Чеботарев (фамилия)']
Нету слова 切博塔列娃 | ['切博塔列娃', 'qiē bó tǎ liè wá', 'Чеботарева (фамилия)']
Нету слова 汇益 | ['汇益', '_', 'Гиперион']
Нету слова 盖尔布 | ['盖尔布', 'gài’ěrbù', 'Гельб Игнас (американский лингвист 1907-1985)']
---------------------
Итого не найдено: 2781
(.venv) PS C:\Users\dns80\Рабочий стол\учёба\4 курс\7 семестр\devOps\ci-cd> 