Есть в dict, нет в html

Нету слова 单叶松 | ['dānyèsōng', '[ref]单叶果松[/ref]']
Нету слова 学术流动 | ['xuéshù liúdòng', 'академическая мобильность']
Нету слова 狐尾松 | ['húwěisōng', 'сосна Бальфура [i](лат. Pinus balfouriana subsp. balfouriana)[/i]']
Нету слова 巧家五针松 | ['_', '[ref]五针白皮松[/ref]']
Нету слова 杉叶松 | ['_', 'Pinus krempfii']
Нету слова 墨西哥五针松 | ['_', 'Pinus ayacahuite']
Нету слова 奇瓦瓦五针松 | ['_', 'Pinus strobiformis subsp. strobiformis']
Нету слова 马其顿五针松 | ['mǎqídùn wǔzhēnsōng', 'сосна румелийская [i](лат. Pinus peuce)[/i]']
Нету слова 北日本五针松 | ['_', 'Pinus parviflora var. pentaphylla']
Нету слова 越南五针松 | ['_', 'Pinus dalatensis var. dalatensis']
Нету слова 华南五针松 | ['_', 'Pinus kwangtungensis var. kwangtungensis']
Нету слова 山罗五针松 | ['_', 'Pinus eremitana']
Нету слова 松塔豆 | ['_', 'Dimorphandra exaltata']
Нету слова 松尾菊 | ['_', 'Parafaujasia mauritiana']
Нету слова 巴尔瑙尔美景 | ['bā’ěrnǎo’ěr měijǐng', 'барнаульские красоты']
Нету слова 湖南参 | ['_', '[ref]粉背羽叶参[/ref]']
Нету слова 李恒羽叶参 | ['_', 'Aralia lihengiana']
Нету слова 善业香肠 | ['shànyè xiāngcháng', 'деловая колбаса']
Нету слова 轮伞羽叶参 | ['_', 'Aralia verticillata']
Нету слова 红色溲疏 | ['hóngsè sōushū', '[ref]粉红溲疏[/ref]']
Нету слова 大果苏瓣檀 | ['_', 'Bussea eggelingii']
Нету слова 苏瓣檀 | ['_', 'Bussea massaiensis']
Нету слова 马岛苏瓣檀 | ['_', 'Bussea sakalava']
Нету слова 苏丁草 | ['_', 'Perdicium capense']
Нету слова 醉人花属 | ['zuìrénhuā shǔ', '[ref]苏甲草属[/ref]']
Нету слова 苏鳞苔属 | ['_', 'род Soella']
Нету слова 苏鳞苔 | ['_', 'Soella obtusifolia']
Нету слова 苏缕木 | ['_', 'Thysanostemon pakaraimae']
Нету слова 苏桃木属 | ['sūtáomù shǔ', 'род теедия [i](лат. Teedia)[/i]']
Нету слова 苏藤蕨属 | ['_', 'род Thysanosoria']
Нету слова 苏芸丹属 | ['_', 'род Comoliopsis']
Нету слова 苏芸丹 | ['_', 'Comoliopsis neblinae']
Нету слова 西南宿苞豆 | ['_', 'Shuteria vestita']
Нету слова 粟米草属 | ['_', 'род Trigastrotheca']
Нету слова 岩生粟米草 | ['_', 'Trigastrotheca rupestris']
Нету слова 荒漠粟特蓬 | ['_', 'Turania deserticola']
Нету слова 安哥拉素馨 | ['_', 'Jasminum angolense']
Нету слова 白萼素馨 | ['_', 'Jasminum albicalyx']
Нету слова 优底迦花 | ['_', 'Jasminum auriculatum']
Нету слова 天星茉莉 | ['tiānxīng mòli', '[ref]优底迦花[/ref]']
Нету слова 皱毛红素馨 | ['zhòumáo hóngsùxīn', '[ref]红素馨[/ref]']
Нету слова 小酒瓶花 | ['xiǎojiǔpínghuā', '[ref]红素馨[/ref]']
Нету слова 肌贴 | ['jītiē', '[ref]肌内效贴[/ref]']
Нету слова 密花素馨 | ['_', 'Jasminum coarctatum var. coarctatum']
Нету слова 毛萼素馨 | ['_', 'Jasminum pilosicalyx']
Нету слова 印度素馨 | ['_', '[ref]双子素馨[/ref]']
Нету слова 夹竹桃叶素馨 | ['_', '[ref]丛林素馨[/ref]']
Нету слова 黄素馨 | ['_', 'Jasminum floridum subsp. giraldii']
Нету слова 素馨针 | ['sùxīnzhēn', '[ref]素馨花[/ref]']
Нету слова 广西素馨 | ['_', 'Jasminum guangxiense']
Нету слова 清香藤 | ['_', 'Jasminum lanceolarium']
Нету слова 到顶衣柜 | ['dàodǐng yīguì', 'шкаф до потолка', 'шкаф в потолок']
Нету слова 四真谛 | ['sìzhēndì', '[ref]四谛[/ref]']
Нету слова 苦灭道圣谛 | ['kǔmièdào shèngdì', '[ref]四谛[/ref]']
Нету слова 汉隆剃刀 | ['hànlóng tìdāo', 'бритва Хэнлона']
Нету слова 岭南茉莉 | ['lǐngnán mòli', '[ref]桂叶素馨[/ref]']
Нету слова 小萼素馨 | ['_', 'Jasminum microcalyx']
Нету слова 蟹角胆藤 | ['_', '[ref]青藤仔[/ref]']
Нету слова 侧鱼胆 | ['_', '[ref]青藤仔[/ref]']
Нету слова 串串金 | ['chuànchuànjīn', '[ref]迎春花[/ref]']
Нету слова 浓香探春 | ['_', '[ref]金茉莉[/ref]']
Нету слова 费欧娜 | ['_', 'Jasminum officinale Siona Sunrise']
Нету слова 厚叶素馨 | ['_', 'Jasminum pentaneurum']
Нету слова 心叶茉莉 | ['_', '[ref]心叶素馨[/ref]']
Нету слова 鸡爪花 | ['jīzhuǎhuā', '[ref]多花素馨[/ref]']
Нету слова 蒲氏素馨 | ['_', '']
Нету слова 云南素馨 | ['_', 'Jasminum yunnanense']
Нету слова 亮叶茉莉 | ['_', '[ref]亮叶素馨[/ref]']
Нету слова 攀枝花素馨 | ['_', 'Jasminum seguinii var. panzhihuaense']
Нету слова 滇南素馨 | ['_', '[ref]腺叶素馨[/ref]']
Нету слова 粉毛素馨 | ['_', '[ref]滇素馨[/ref]']
Нету слова 异叶素馨 | ['_', 'Jasminum anisophyllum']
Нету слова 元江素馨 | ['_', 'Jasminum yuanjiangense']
Нету слова 粉果花 | ['fěnguǒhuā', '[ref]紫茉莉[/ref]']
Нету слова 粉豆花 | ['fěndòuhuā', '[ref]紫茉莉[/ref]']
Нету слова 煮饭花 | ['zhǔfànhuā', '[ref]紫茉莉[/ref]']
Нету слова 地雷花 | ['dìléihuā', '[ref]紫茉莉[/ref]']
Нету слова 烧汤花 | ['shāotānghuā', '[ref]紫茉莉[/ref]']
Нету слова 素香 | ['sùxiāng', '[ref]紫茉莉[/ref]']
Нету слова 印度酸脚杆 | ['_', 'Pseudodissochaeta assamica']
Нету слова 非洲酸蔹藤 | ['_', 'Ampelocissus africana']
Нету слова 密头酸蔹藤 | ['_', 'Ampelocissus obtusata subsp. kirkiana']
Нету слова 紫茎酸模 | ['_', 'Rumex angulatus']
Нету слова 密生酸模 | ['mìshēng suānmó', 'щавель конский [i](лат. Rumex confertus)[/i]']
Нету слова 戟叶酸模 | ['_', 'Rumex hastatus']
Нету слова 牛舌菜 | ['niúshécài', '[ref]羊蹄[/ref]2)']
Нету слова 单瘤酸模 | ['dānliú suānmó', 'щавель Маршалла [i](лат. Rumex marschallianus)[/i]']
Нету слова 疏花酸模 | ['_', 'Rumex nepalensis var. remotiflorus']
Нету слова 中亚酸模 | ['zhōngyà suānmó', 'щавель Попова [i](лат. Rumex popovii)[/i]']
Нету слова 蒙新酸模 | ['méngxīn suānmó', 'щавель подобный [i](лат. Rumex similans)[/i]']
Нету слова 非洲酸模 | ['_', 'Rumex steudelii']
Нету слова 直根酸模 | ['zhígēn suānmó', 'щавель пирамидальный [i](лат. Rumex thyrsiflorus)[/i]']
Нету слова 谢尔巴茨基 | ['xiè’ěrbācíjī', 'Щербатский', 'Щербацкий [i](фамилия)[/i]']
Нету слова 谢尔巴托娃 | ['xiè’ěrbātuōwá', 'Щербатова [i](фамилия)[/i]']
Нету слова 谢兰斯基 | ['xièlánsījī', 'Щеранский [i](фамилия)[/i]']
Нету слова 谢波捷娃 | ['xièbōjiéwá', 'Щепотева', 'Щепотьева [i](фамилия)[/i]']
Нету слова 谢普金娜 | ['xièpǔjīnnà', 'Щепкина [i](фамилия)[/i]']
Нету слова 谢皮洛 | ['xièpíluò', 'Щепилло [i](фамилия)[/i]']
Нету слова 谢佩京 | ['xièpèijīng', 'Щепетин [i](фамилия)[/i]']
Нету слова 谢佩季利尼科娃 | ['xièpèijìlì’níkēwá', 'Щепетильникова [i](фамилия)[/i]']
Нету слова 谢尔宾斯基娅 | ['xiè’ěrbīnsījīyà', 'Щербинская [i](фамилия)[/i]']
Нету слова 谢尔巴茨基赫 | ['xiè’ěrbācíjīhè', 'Щербатских [i](фамилия)[/i]']
Нету слова 谢尔巴乔娃 | ['xiè’ěrbāqiáowá', 'Щербачёва [i](фамилия)[/i]']
Нету слова 谢尔比茨基 | ['xiè’ěrbǐcíjī', 'Щербицкий [i](фамилия)[/i]']
Нету слова 谢尔博维奇 | ['xiè’ěrbówéiqí', 'Щербович [i](фамилия)[/i]']
Нету слова 谢京金娜 | ['xièjīngjīnnà', 'Щетинкина [i](фамилия)[/i]']
Нету слова 晓特金 | ['xiǎotèjīn', 'Щёткин [i](фамилия)[/i]']
Нету слова 谢乌洛娃 | ['xièwūluòwá', 'Щеулова [i](фамилия)[/i]']
Нету слова 希格列娃 | ['xīgélièwá', 'Щиглева [i](фамилия)[/i]']
Нету слова 希帕诺夫 | ['xīpà’nuòfū', 'Щипанов [i](фамилия)[/i]']
Нету слова 希波尼科娃 | ['xībōníkēwá', 'Щипоникова [i](фамилия)[/i]']
Нету слова 晓德罗 | ['xiǎodéluó', 'Щодро [i](фамилия)[/i]']
Нету слова 休济姆 | ['xiūjìmǔ', 'Щузьм [i](фамилия)[/i]']
Нету слова 休卡耶娃 | ['xiūkǎyēwá', 'Щукаева [i](фамилия)[/i]']
Нету слова 休科 | ['xiūkē', 'Щуко [i](фамилия)[/i]']
Нету слова 休列普尼科娃 | ['xiūlièpǔníkēwá', 'Щулепникова [i](фамилия)[/i]']
Нету слова 休普洛夫 | ['xiūpǔluòfū', 'Щуплов [i](фамилия)[/i]']
Нету слова 休拉特 | ['xiūlātè', 'Щурат [i](фамилия)[/i]']
Нету слова 休连科娃 | ['xiūliánkēwá', 'Щуренкова [i](фамилия)[/i]']
Нету слова 休罗夫 | ['xiūluófū', 'Щуров [i](фамилия)[/i]']
Нету слова 休罗夫斯基娅 | ['xiūluófūsījīyà', 'Щуровская [i](фамилия)[/i]']
Нету слова 休谢娃 | ['xiūxièwá', 'Щусева [i](фамилия)[/i]']
Нету слова 休茨科伊 | ['xiūcíkēyī', 'Щуцкой [i](фамилия)[/i]']
Нету слова 休奇金娜 | ['xiūqíjīnnà', 'Щучкина [i](фамилия)[/i]']
Нету слова 厄泽姆 | ['èzémǔ', 'Ырзем [i](фамилия)[/i]']
Нету слова 埃巴诺伊泽 | ['āibā’nuòyīzé', 'Эбаноидзе [i](фамилия)[/i]']
Нету слова 埃别里谢夫 | ['āibiélǐxièfū', 'Эберисев [i](фамилия)[/i]']
Нету слова 埃伯曼 | ['āibómàn', 'Эберман [i](фамилия)[/i]']
Нету слова 埃比亚 | ['āibǐyà', 'Эбия [i](фамилия)[/i]']
Нету слова 埃瓦尔德 | ['āiwǎ’ěrdé', 'Эвалд', 'Эвальд [i](имя)[/i]']
Нету слова 埃瓦泰内 | ['āiwǎtàinèi', 'Эватэнэ [i](фамилия)[/i]']
Нету слова 埃韦尔松 | ['āiwéi’ěrsōng', 'Эвельсон [i](фамилия)[/i]']
Нету слова 埃文列娃 | ['āiwénlièwá', 'Эвенлева [i](фамилия)[/i]']
Нету слова 埃文托娃 | ['āiwéntuōwá', 'Эвентова [i](фамилия)[/i]']
Нету слова 埃韦尔格季多夫 | ['āiwéi’ěrgéjìduōfū', 'Эвергетидов [i](фамилия)[/i]']
Нету слова 埃韦尔格托娃 | ['āiwéi’ěrgétuōwá', 'Эвергетова [i](фамилия)[/i]']
Нету слова 埃韦特 | ['āiwéitè', 'Эверт [i](фамилия)[/i]']
Нету слова 埃沃林斯基 | ['āiwòlínsījī', 'Эволинский [i](фамилия)[/i]']
Нету слова 埃维扬 | ['āiwéiyáng', 'Эвьян [i](фамилия)[/i]']
Нету слова 埃加特 | ['āijiātè', 'Эгарт [i](фамилия)[/i]']
Нету слова 埃金克 | ['āijīnkè', 'Эггинк [i](фамилия)[/i]']
Нету слова 埃根别尔季耶夫 | ['āigēnbié’ěrjìyēfū', 'Эгембердиев [i](фамилия)[/i]']
Нету слова 埃格斯 | ['āigésī', 'Эгерс [i](фамилия)[/i]']
Нету слова 埃吉兹 | ['āijízī', 'Эгиз [i](фамилия)[/i]']
Нету слова 埃吉娜 | ['āijí‘nà', 'Эгина [i](имя)[/i]']
Нету слова 埃格林斯基娅 | ['āigélínsījīyà', 'Эглинская [i](фамилия)[/i]']
Нету слова 埃格隆 | ['āigélóng', 'Эглон [i](фамилия)[/i]']
Нету слова 埃达西 | ['āidáxī', 'Эдаси [i](фамилия)[/i]']
Нету слова 埃德华达斯 | ['āidéhuádásī', 'Эдвардас [i](имя)[/i]']
Нету слова 埃杰济 | ['āijiéjì', 'Эдези [i](фамилия)[/i]']
Нету слова 埃德尔漫 | ['āidé’ěrmàn', 'Эдельман [i](фамилия)[/i]']
Нету слова 埃德尔菲尔特 | ['āidé’ěrfēiěrtè', 'Эдельфельт [i](фамилия)[/i]']
Нету слова 埃杰姆斯基娅 | ['āijiémǔsījīyà', 'Эдемская [i](фамилия)[/i]']
Нету слова 内味 | ['nèiwèi', 'тот самый вкус', 'именно этот вкус', 'то самое ощущение ([i]内 вместо 那[/i])[*]依旧是内味儿 по прежнему то самое ощущение[/*]']
Нету слова 关节置换 | ['guānjié zhìhuàn', 'артропластика']
Нету слова 埃朱莫夫 | ['āizhūmòfū', 'Эджумов [i](фамилия)[/i]']
Нету слова 埃迪格尔 | ['āidígé’ěr', 'Эдигер [i](фамилия)[/i]']
Нету слова 埃迪特 | ['āidítè', '1) Эдиет [i](фамилия)[/i]2) Эдит', 'Эдите [i](имя)[/i]']
Нету слова 埃德林斯基 | ['āidélínsījī', 'Эдлинский [i](фамилия)[/i]']
Нету слова 埃多姆斯基 | ['āiduōmǔsījī', 'Эдомский [i](фамилия)[/i]']
Нету слова 爱德华多夫 | ['àidéhuáduōfū', 'Эдуардов [i](фамилия)[/i]']
Нету слова 埃兹德林 | ['āizīdélín', 'Эздрин [i](фамилия)[/i]']
Нету слова 埃泽科娃 | ['āizékēwá', 'Эзекова [i](фамилия)[/i]']
Нету слова 埃泽林 | ['āizélín', 'Эзрин [i](фамилия)[/i]']
Нету слова 埃佐夫 | ['āizuǒfū', 'Эзов [i](фамилия)[/i]']
Нету слова 埃佐波娃 | ['āizuǒbōwá', 'Эзопова [i](фамилия)[/i]']
Нету слова 埃兹林娜 | ['āizīlínnà', 'Эзрина [i](фамилия)[/i]']
Нету слова 艾巴托娃 | ['àibātuōwá', 'Эйбатова [i](фамилия)[/i]']
Нету слова 艾贝格 | ['àibèigé', 'Эйберг [i](фамилия)[/i]']
Нету слова 艾根松 | ['àigēnsōng', 'Эйгенсон [i](фамилия)[/i]']
Нету слова 艾金娜 | ['àijīnnà', 'Эйгина [i](фамилия)[/i]']
Нету слова 艾德尔贝格 | ['àidé’ěrbèigé', 'Эйдельберг [i](фамилия)[/i]']
Нету слова 艾德尔曼 | ['àidé’ěrmàn', 'Эйдельман [i](фамилия)[/i]']
Нету слова 艾德尔施泰因 | ['àidé’ěrshītàiyīn', 'Эйдельштейн [i](фамилия)[/i]']
Нету слова 艾德斯 | ['àidésī', 'Эйдес [i](фамилия)[/i]']
Нету слова 艾德鲁克 | ['àidélǔkè', 'Эйдрук [i](фамилия)[/i]']
Нету слова 艾杜莫夫 | ['àidùmòfū', 'Эйдумов [i](фамилия)[/i]']
Нету слова 艾杜斯 | ['àidùsī', 'Эйдус [i](фамилия)[/i]']
Нету слова 艾萨 | ['àisà', 'Эйса [i](имя)[/i]']
Нету слова 艾泽林 | ['àizélín', 'Эйзеринг [i](фамилия)[/i]']
Нету слова 艾斯勒 | ['àisīlè', 'Эйзлер [i](фамилия)[/i]']
Нету слова 艾勒 | ['àilè', 'Эйлер [i](фамилия)[/i]']
Нету слова 艾梅托夫 | ['àiméituōfū', 'Эйметов [i](фамилия)[/i]']
Нету слова 艾蒙托夫 | ['àiméngtuōfū', 'Эймонтов [i](фамилия)[/i]']
Нету слова 艾纳罗维奇 | ['àinàluówéiqí', 'Эйнарович [i](фамилия)[/i]']
Нету слова 艾因贝格 | ['àiyīnbèigé', 'Эйнберг [i](фамилия)[/i]']
Нету слова 艾因戈恩 | ['àiyīngē’ēn', 'Эйнгорн [i](фамилия)[/i]']
Нету слова 艾尼斯 | ['àinísī', 'Эйнис [i](фамилия)[/i]']
Нету слова 艾波特 | ['àibōtè', 'Эйпорт [i](фамилия)[/i]']
Нету слова 艾拉姆占茨 | ['àilāmǔzhàncí', 'Эйрамджанц [i](фамилия)[/i]']
Нету слова 艾斯蒙德 | ['àisīméngdé', 'Эйсмонд', 'Эйсмонт [i](фамилия)[/i]']
Нету слова 艾特维德 | ['àitèwéidé', 'Эйтвид [i](фамилия)[/i]']
Нету слова 艾费特 | ['àifèitè', 'Эйферт [i](фамилия)[/i]']
Нету слова 艾希 | ['àixī', 'Эйх [i](фамилия)[/i]']
Нету слова 艾兴布拉特 | ['àixīngbùlātè', 'Эйхемблат [i](фамилия)[/i]']
Нету слова 亚硫酸氢烟酰胺甲萘醌 | ['yàliúsuānqīng yānxiān’àn jiǎnàikūn', 'менадиона никотинамид бисульфит']
Нету слова 蒜香草属 | ['suànxiāngcǎo shǔ', 'род петиверия [i](лат. Petiveria)[/i]']
Нету слова 蛇铃藤 | ['_', 'Mansoa difficilis']
Нету слова 小蒜香藤 | ['_', 'Mansoa hymenacea']
Нету слова 安徽碎米荠 | ['_', 'Cardamine anhuiensis']
Нету слова 博氏碎米荠 | ['bóshì suìmǐjì', '[ref]贵阳碎米荠[/ref]']
Нету слова 卸车次数 | ['xièchē cìshù', 'количество разгрузок']
Нету слова 九叶碎米荠 | ['_', 'Cardamine enneaphyllos']
Нету слова 法氏碎米荠 | ['_', '[ref]城口碎米荠[/ref]']
Нету слова 七叶石芥花 | ['_', 'Cardamine heptaphylla']
Нету слова 壶瓶碎米荠 | ['_', 'Cardamine hupingshanensis']
Нету слова 多叶石芥花 | ['_', 'Cardamine kitaibelii']
Нету слова 湖米荠 | ['_', 'Cardamine lacustris']
Нету слова 多裂碎米荠 | ['_', 'Cardamine multijuga']
Нету слова 石芥花 | ['shíjièhuā', 'сердечник пятилистный', 'зубянка пятилистная [i](лат. Cardamine pentaphyllos)[/i]']
Нету слова 石芥菜 | ['shíjiècài', 'сердечник тангутский [i](лат. Cardamine tangutorum)[/i]']
Нету слова 瑞士石芥花 | ['_', 'Cardamine × killiasii']
Нету слова 碎米藓属 | ['suìmǐxiǎn shǔ', 'род фаброния [i](лат. Fabronia)[/i]']
Нету слова 轻度感谢 | ['qīngdù gǎnxiè', 'маленькое спасибо']
Нету слова 刀友 | ['dāoyǒu', 'друг по оружию', 'друг по ножу [i](по ножевому бою или метанию ножей)[/i]']
Нету слова 拼音系统 | ['pīnyīn xìtǒng', 'система пиньинь']
Нету слова 汉语拼音系统 | ['hànyǔ pīnyīn xìtǒng', 'транскрипционная система китайского языка', 'система Ханьюй пиньинь']
Нету слова 追加保证金通知 | ['zhuījiā bǎozhèngjīn tōngzhī', '[ref]补仓通知[/ref]']
Нету слова 利普采尔 | ['lìpǔcǎi’ěr', 'Липцер [i](фамилия)[/i]']
Нету слова 聚胺脂 | ['_', '[ref]聚氨酯[/ref]']
Нету слова 餐后犯困 | ['cānhòu fànkùn', '[ref]餐后嗜睡[/ref]']
Нету слова 宇宙行 | ['yǔzhòuháng', 'Мировой Банк ([i]прозвище Промышленного и коммерческого банка Китая', 'являющегося самым большим в мире по активам[/i])']
Нету слова 东亚碎米藓 | ['_', 'Fabronia matsumurae']
Нету слова 展枝碎米藓 | ['_', 'Fabronia patentissima']
Нету слова 陕西碎米藓 | ['_', 'Fabronia schensiana']
Нету слова 杯穗榄 | ['_', 'Scyphostachys coffeoides']
Нету слова 穗巴戟属 | ['_', 'род Cowiea']
Нету слова 穗百金花属 | ['suì bǎijīnhuā shǔ', 'род шенкия [i](лат. Schenkia)[/i]']
Нету слова 夏威夷穗百金花 | ['_', 'Schenkia sebaeoides']
Нету слова 穗核草 | ['_', 'Trichostachys longifolia']
Нету слова 东非穗霉草 | ['_', 'Kupea jonii']
Нету слова 高度危险走私 | ['gāodù wēixiǎn zǒusī', 'особо опасный вид контрабанды']
Нету слова 穗南苏 | ['_', 'Physopsis spicata']
Нету слова 高山穗三毛草 | ['gāoshān suìsānmáocǎo', '[ref]高山三毛草[/ref]']
Нету слова 柔弱穗三毛草 | ['_', '[ref]柔弱三毛草[/ref]']
Нету слова 穗三毛草 | ['suìsānmáocǎo', 'трищетинник колосистый [i](лат. Trisetum spicatum subsp. spicatum)[/i]']
Нету слова 西藏穗三毛 | ['xīzàng suìsānmáo', '[ref]西藏穗三毛草[/ref]']
Нету слова 云南三毛草 | ['yúnnán sānmáocǎo', '[ref]云南穗三毛草[/ref]']
Нету слова 穗心莲 | ['_', 'Graphandra procumbens']
Нету слова 穗枝苔 | ['suìzhītái', 'празантус шведский [i](лат. Prasanthus suecicus)[/i]']
Нету слова 须尾娑罗双 | ['_', 'Shorea maxwelliana']
Нету слова 娑罗双 | ['suōluóshuāng', 'сал', 'шорея исполинская [i](лат. Shorea robusta)[/i]']
Нету слова 娑羽树 | ['_', 'Bersama abyssinica']
Нету слова 关节桫椤 | ['_', 'Alsophila articulata']
Нету слова 中华桫椤 | ['_', 'Alsophila costularis']
Нету слова 南洋桫椤 | ['_', 'Alsophila loheri']
Нету слова 波纳佩桫椤 | ['_', 'Alsophila ponapeana']
Нету слова 毛叶桫椤 | ['_', 'Alsophila andersoni']
Нету слова 丘民桫椤 | ['_', 'Cyathea cunninghamii']
Нету слова 台湾树蕨 | ['_', '[ref]小黑桫椤[/ref]']
Нету слова 鬼桫椤 | ['_', 'Alsophila podophylla']
Нету слова 大羽桫椤 | ['_', 'Cyathea contaminans']
Нету слова 新月桫椤 | ['_', 'Cyathea lunulata']
Нету слова 黑色桫椤 | ['_', 'Cyathea nigricans']
Нету слова 朱笔石南 | ['_', 'Conostephium drummondii']
Нету слова 梭梭柴 | ['suōsuōchái', '[ref]梭梭[/ref]2)']
Нету слова 印度梭梭 | ['_', 'Haloxylon indicum']
Нету слова 独眼立凤莲 | ['_', 'Pontederia meyeri']
Нету слова 立凤莲 | ['_', 'Pontederia paradoxa']
Нету слова 澳洲雨久花 | ['_', 'Pontederia cyanea']
Нету слова 窄叶鸭舌草 | ['_', 'Pontederia plantaginea']
Нету слова 异子凤眼莲 | ['_', 'Pontederia heterosperma']
Нету слова 巨梭鱼草 | ['_', 'Pontederia gigantea']
Нету слова 卵叶梭鱼草 | ['_', 'Pontederia ovalis']
Нету слова 卷苞梭鱼草 | ['_', 'Pontederia reflexa']
Нету слова 近卵叶丽鱼草 | ['_', 'Pontederia subovata']
Нету слова 齿边缩叶藓 | ['_', 'Ptychomitrium dentatum']
Нету слова 台湾缩叶藓 | ['_', 'Ptychomitrium formosicum']
Нету слова 疣胞缩叶藓 | ['_', 'Ptychomitrium mamillosum']
Нету слова 威氏缩叶藓 | ['_', 'Ptychomitrium wilsonii']
Нету слова 莎草蕨 | ['_', 'Actinostachys digitata']
Нету слова 小风车草 | ['_', 'Cyperus alternifolius subsp. textilis']
Нету слова 雨颖莎属 | ['yǔyǐngshā shǔ', 'род алинула [i](лат. Alinula)[/i]']
Нету слова 胀颖莎属 | ['zhàngyǐngshā shǔ', 'род асколепис [i](лат. Ascolepis)[/i]']
Нету слова 翅鳞莎属 | ['chìlínshā shǔ', 'род куртоизина [i](лат. Courtoisina)[/i]']
Нету слова 多脉莎草属 | ['_', 'род Eucyperus']
Нету слова 矮水蜈蚣属 | ['_', 'род Hedychloe']
Нету слова 水莎草属 | ['shuǐsuōcǎo shǔ', 'род ситничек [i](лат. Juncellus)[/i]']
Нету слова 秘鲁水蜈蚣属 | ['_', 'род Lyprolepis']
Нету слова 莎状砖子苗属 | ['_', 'род Opetiola']
Нету слова 慢性细菌性前列腺炎 | ['mànxìng xìjūnxìng qiánliè xiànyán', 'хронический бактериальный простатит']
Нету слова 海滨莎属 | ['_', 'род Remirea']
Нету слова 密穗砖子苗属 | ['_', 'род Sphaeromariscus']
Нету слова 三穗湖瓜草属 | ['_', 'род Tunga']
Нету слова 华湖瓜草 | ['_', 'Cyperus albescens']
Нету слова 短叶水蜈蚣 | ['duǎnyè shuǐwúgōng', 'киллинга коротколистная [i](лат. Kyllinga brevifolia)[/i]']
Нету слова 金钮草 | ['jīnniǔcǎo', '[ref]短叶水蜈蚣[/ref]']
Нету слова 喀麦隆莎草 | ['_', 'Cyperus camerunensis']
Нету слова 莎状砖子苗 | ['_', 'Cyperus cyperinus']
Нету слова 鳞茎砖子苗 | ['_', 'Cyperus dubius']
Нету слова 海南砖子苗 | ['_', 'Cyperus hainanensis']
Нету слова 山东白鳞莎草 | ['_', 'Cyperus hilgendorfianus']
Нету слова 沼生水莎草 | ['zhǎoshēng shuǐsuōcǎo', 'сыть илистая [i](лат. Cyperus limosus)[/i]']
Нету слова 波密苔草 | ['bōmì táicǎo', '[ref]波密薹草[/ref]']
Нету слова 花穗水莎草 | ['huāsuì shuǐsuōcǎo', 'сыть венгерская [i](лат. Cyperus pannonicus)[/i]']
Нету слова 小纸莎 | ['_', 'Cyperus prolifer']
Нету слова 假疏穗莎草 | ['_', 'Cyperus pseudodistans']
Нету слова 辐射砖子苗 | ['_', 'Cyperus radians']
Нету слова 水莎草 | ['shuǐsuōcǎo', 'ситничек поздний', 'сыть Литвинова', 'сыть поздняя [i](лат. Juncellus serotinus)[/i]']
Нету слова 圆筒穗水蜈蚣 | ['_', 'Cyperus sesquiflorus subsp. cylindricus']
Нету слова 苏里南莎草 | ['_', '[ref]刺稈莎草[/ref]']
Нету слова 水社扁莎 | ['_', '[ref]禾状扁莎[/ref]']
Нету слова 塔藓属 | ['tǎxiǎn shǔ', 'род гилокомий', 'гилокомиум [i](лат. Hylocomium)[/i]']
Нету слова 塔叶苔 | ['tǎyètái', 'шифнерия бесцветная [i](лат. Schiffneria hyalina)[/i]']
Нету слова 台闽苣苔属 | ['táimǐn jùtái shǔ', 'род титанотрихум [i](лат. Titanotrichum)[/i]']
Нету слова 台湾山柚 | ['_', 'Champereia manillana']
Нету слова 广东台湾藓 | ['_', 'Taiwanobryum guangdongense']
Нету слова 粗肋台湾藓 | ['_', 'Taiwanobryum undulatifolium']
Нету слова 圆钝苔叶藓 | ['_', 'Aulacopilum abbreviatum']
Нету слова 东欧悬穗薹草 | ['_', 'Carex agastachys']
Нету слова 绳根薹草 | ['shénggēn táicǎo', 'осока плетевидная [i](лат. Carex chordorrhiza)[/i]']
Нету слова 绳根苔草 | ['shénggēn táicǎo', '[ref]绳根薹草[/ref]']
Нету слова 欧苔草 | ['ōutáicǎo', '[ref]欧薹草[/ref]']
Нету слова 卵形苔草 | ['luǎnxíng táicǎo', '[ref]卵形薹草[/ref]']
Нету слова 阔囊甘松薹草 | ['kuònáng gānsōng táicǎo', 'осока Хэпберна [i](лат. Carex nardina var. hepburnii)[/i]']
Нету слова 苍穗薹草 | ['cāngsuì táicǎo', 'осока бледноватая [i](лат. Carex pallescens)[/i]']
Нету слова 山针薹草 | ['shān zhēntáicǎo', 'осока малоцветковая [i](лат. Carex pauciflora)[/i]']
Нету слова 叶穗 | ['yèsuì', 'листоколосый']
Нету слова 多穗薹草 | ['_', 'Carex polycephala']
Нету слова 多穗苔草 | ['duōsuì táicǎo', '[ref]多穗薹草[/ref]']
Нету слова 崖薹草 | ['_', 'Carex scopulorum var. scopulorum']
Нету слова 细穗林薹草 | ['xìsuì líntáicǎo', 'осока щетинистая [i](лат. Carex strigosa)[/i]']
Нету слова 林生薹草 | ['_', 'Carex sylvatica']
Нету слова 北美叶穗薹草 | ['_', 'Carex willdenowii']
Нету слова 南湖苔草 | ['nánhú táicǎo', '[ref]南湖薹草[/ref]']
Нету слова 刺叶苔草 | ['cìyè táicǎo', '[ref]刺叶薹草[/ref]']
Нету слова 林下薹 | ['_', 'Carex alliiformis']
Нету слова 碧江薹草 | ['_', 'Carex bijiangensis']
Нету слова 短莛薹草 | ['_', 'Carex breviscapa']
Нету слова 棕红苔草 | ['zōnghóng táicǎo', '[ref]棕红薹草[/ref]']
Нету слова 褐红苔草 | ['hèhóng táicǎo', '[ref]褐红薹草[/ref]']
Нету слова 烟火薹 | ['yānhuǒtái', '[ref]十字薹草[/ref]']
Нету слова 大明山苔草 | ['dàmíngshān táicǎo', '[ref]大明山薹草[/ref]']
Нету слова 金华苔草 | ['jīnhuá táicǎo', '[ref]金华薹草[/ref]']
Нету слова 泰林兰 | ['_', 'Paorchis thailandica']
Нету слова 三阳苔草 | ['sānyáng táicǎo', '[ref]三阳薹草[/ref]']
Нету слова 发缵薹草 | ['_', 'Carex fatsuaniana']
Нету слова 依班娜 | ['yībānnà', 'Ibanez [i](гитарный бренд)[/i]']
Нету слова 乐东薹草 | ['_', 'Carex ledongensis']
Нету слова 扭喙苔草 | ['niǔhuì táicǎo', '[ref]扭喙薹草[/ref]']
Нету слова 陇南薹草 | ['_', 'Carex minxianensis']
Нету слова 脚苔 | ['jiǎotái', '[ref]柄状薹草[/ref]']
Нету слова 红鳞薹草 | ['hónglín táicǎo', '[ref]狭囊薹草[/ref]']
Нету слова 橄绿果苔草 | ['gǎnlǜguǒ táicǎo', '[ref]橄绿果薹草[/ref]']
Нету слова 半行政套房 | ['bànxíngzhèng tàofáng', 'полулюкс ([i]категория гостиничного номера[/i])']
Нету слова 华人与狗不能入内 | ['huárén yǔ gǒu bùnéng rùnèi', 'китайцам и собакам вход запрещён']
Нету слова 扁秆 | ['biǎngǎn', 'плоский стебель', 'плоскостебельный']
Нету слова 人民论坛 | ['rénmín lùntán', '«Народная трибуна» [i](теоретический журнал КПК)[/i]']
Нету слова 囊草 | ['nángcǎo', '[ref]褐果薹草[/ref]']
Нету слова 粟褐苔草 | ['sùhè táicǎo', '[ref]褐果薹草[/ref]']
Нету слова 若夫坚 | ['ruòfūjiān', 'Жовтень ([i]топоним)[/i]']
Нету слова 亚佐娃 | ['yàzuǒwá', 'Язова [i](фамилия)[/i]']
Нету слова 棉花案 | ['miánhuā’àn', 'Хлопковое дело [i](собирательное название серии уголовных дел об экономических и коррупционных злоупотреблениях', 'выявленных в Узбекской ССР', 'расследование которых проводилось в конце 1970—1980-х гг.)[/i]']
Нету слова 淡色艾尔 | ['dànsè àiěr', 'светлый эль']
Нету слова 棕色艾尔 | ['zōngsè àiěr', 'бурый эль']
Нету слова 假松叶薹草 | ['jiǎ sōngyè táicǎo', '[ref]松叶薹草[/ref]']
Нету слова 块茎苔草 | ['kuàijīng táicǎo', '[ref]高节薹草[/ref]']
Нету слова 湘西苔草 | ['xiāngxī táicǎo', '[ref]湘西薹草[/ref]']
Нету слова 贺州薹草 | ['_', 'Carex hezhouensis']
Нету слова 葱岭薹草 | ['cōnglǐng táicǎo', 'осока алайская [i](лат. Carex alajica)[/i]']
Нету слова 清凉峰苔草 | ['qīngliángfēng táicǎo', '[ref]清凉峰薹草[/ref]']
Нету слова 樟木苔草 | ['zhāngmù táicǎo', '[ref]樟木薹草[/ref]']
Нету слова 东亚苔草 | ['dōngyà táicǎo', '[ref]东亚薹草[/ref]']
Нету слова 雪霸薹草 | ['_', 'Carex ayako-maedae']
Нету слова 巴马薹草 | ['_', 'Carex bamaensis']
Нету слова 大通薹草 | ['_', 'Carex datongensis']
Нету слова 大新薹草 | ['_', 'Carex daxinensis']
Нету слова 康藏嵩草 | ['_', 'Carex littledalei']
Нету слова 植夫薹草 | ['_', 'Carex fangiana']
Нету слова 洪林薹草 | ['_', 'Carex honglinii']
Нету слова 聚穗薹草 | ['_', 'Carex longicolla']
Нету слова 多节薹草 | ['_', 'Carex nodosa']
Нету слова 福建苔草 | ['fújiàn táicǎo', '[ref]福建薹草[/ref]']
Нету слова 黄山苔草 | ['huángshān táicǎo', '[ref]黄山薹草[/ref]']
Нету слова 溪畔苔草 | ['xīpàn táicǎo', '[ref]溪畔薹草[/ref]']
Нету слова 闽清薹草 | ['_', 'Carex minquinensis']
Нету слова 睫背薹草 | ['_', 'Carex hypoblephara']
Нету слова 凤凰薹草 | ['_', 'Carex hoozanensis']
Нету слова 尤尔都斯苔草 | ['yóu’ěrdūsī táicǎo', '[ref]尤尔都斯薹草[/ref]']
Нету слова 杭州苔草 | ['hángzhōu táicǎo', '[ref]杭州薹草[/ref]']
Нету слова 朝芳苔草 | ['cháofāng táicǎo', '[ref]朝芳薹草[/ref]']
Нету слова 矩圆薹草 | ['_', 'Carex oblanceolata']
Нету слова 天目山薹草 | ['_', 'Carex tianmushanica']
Нету слова 新加坡薹草 | ['_', 'Carex sanjappae']
Нету слова 疏穗苔草 | ['shūsuì táicǎo', '[ref]丝引薹草[/ref]']
Нету слова 橘红薹草 | ['júhóng táicǎo', 'осока кирпичная [i](лат. Carex testacea)[/i]']
Нету слова 斑叶薹草 | ['_', 'Carex variegata']
Нету слова 芒髯苔草 | ['mángrán táicǎo', '[ref]芒髯薹草[/ref]']
Нету слова 药花属叶薹草 | ['yàohuāshǔyè táicǎo', '[ref]丫蕊薹草[/ref]']
Нету слова 藏南薹草 | ['_', 'Carex hemineuros']
Нету слова 密缘毛薹草 | ['mì yuánmáo táicǎo', '[ref]流苏薹草[/ref]']
Нету слова 粗毛流苏苔草 | ['cūmáo liúsū táicǎo', '[ref]粗毛流苏薹草[/ref]']
Нету слова 浙南薹草 | ['_', 'Carex austrozhejiangensis']
Нету слова 浙江薹草 | ['_', 'Carex zhejiangensis']
Нету слова 大庸薹草 | ['_', 'Carex dayuongensis']
Нету слова 斜果苔草 | ['xiéguǒ táicǎo', '[ref]斜果薹草[/ref]']
Нету слова 自电离光谱学 | ['zìdiànlí guāngpǔxué', 'автоионизационная спектроскопия']
Нету слова 单臂式 | ['dānbìshì', 'одноконсольный', 'однорычажный']
Нету слова 近陈氏薹草 | ['_', 'Carex paracheniana']
Нету слова 近陈氏苔草 | ['jìn chénshì táicǎo', '[ref]近陈氏薹草[/ref]']
Нету слова 麦克耳孙干涉仪 | ['màikè ěrsūn gānshèyí', 'интерферометр Майкельсона']
Нету слова 紫鞘薹草 | ['_', 'Carex purpureovaginalis']
Нету слова 紫鞘苔草 | ['zǐqiào táicǎo', '[ref]紫鞘薹草[/ref]']
Нету слова 书带薹 | ['shūdàitái', '[ref]书带薹草[/ref]']
Нету слова 花莛薹草 | ['_', 'Carex scaposa']
Нету слова 崖壁苔草 | ['yábì táicǎo', '[ref]崖壁薹草[/ref]']
Нету слова 无毛条穗薹草 | ['_', 'Carex subglabra']
Нету слова 廷农苔草 | ['tíngnóng táicǎo', '[ref]廷农薹草[/ref]']
Нету слова 合鳞薹草 | ['_', 'Carex tristachya var. pocilliformis']
Нету слова 菊芳苔草 | ['júfāng táicǎo', '[ref]菊芳薹草[/ref]']
Нету слова 云亿苔草 | ['yúnyì táicǎo', '[ref]云亿薹草[/ref]']
Нету слова 檀梅属 | ['_', 'род Vauquelinia']
Нету слова 夏威夷檀香 | ['_', 'Santalum ellipticum']
Нету слова 钝叶檀香桃 | ['_', 'Santalum obtusifolium']
Нету слова 腺粟木 | ['_', 'Mollugo ulei']
Нету слова 种棱粟米草 | ['_', '[ref]毯粟草[/ref]']
Нету слова 探春花属 | ['_', 'род Chrysojasminum']
Нету слова 桤叶唐棣 | ['qīyè tángdì', 'ирга ольхолистная [i](лат. Amelanchier alnifolia var. alnifolia)[/i]']
Нету слова 东亚唐棣 | ['dōngyà tángdì', 'ирга азиатская [i](лат. Amelanchier asiatica)[/i]']
Нету слова 卵叶唐棣 | ['luǎnyè tángdì', 'ирга круглолистная', 'ирга обыкновенная', 'ирга овальнолистная [i](лат. Amelanchier ovalis subsp. ovalis)[/i]']
Нету слова 棒蕊唐松草 | ['_', 'Thalictrum clavatum']
Нету слова 唐松莲花 | ['tángsōng liánhuā', 'анемонелла василистниковая', 'василистник анемоновидный [i](лат. Thalictrum thalictroides)[/i]']
Нету слова 筑紫唐松草 | ['_', 'Thalictrum kiusianum']
Нету слова 香根芹状唐松草 | ['_', 'Thalictrum osmorhizoides']
Нету слова 宽果巴布亚唐松草 | ['_', 'Thalictrum papuanum var. laticarpellum']
Нету слова 球唐松草 | ['_', 'Thalictrum watanabei']
Нету слова 谋势造势 | ['móushì zàoshì', 'планировать и создавать обстановку']
Нету слова 中国实际 | ['zhōngguó shíjì', 'китайские реалии']
Нету слова 文明型国家 | ['wénmíngxíng guójiā', 'цивилизованное государство']
Нету слова 三统一 | ['sāntǒngyī', 'принцип «трёх единств»']
Нету слова 敢打必胜 | ['gǎndǎ bìshèng', 'если вступать в бой', 'то побеждать']
Нету слова 新发展格局 | ['xīn fāzhǎn géjú', 'новая конфигурация развития']
Нету слова 泽被万代 | ['zébèi wàndài', '[ref]泽被苍生[/ref]']
Нету слова 红参果 | ['hóngshēnguǒ', 'циклокодон ланцифолиус ([i]лат. Cyclocodon lancifolius[/i])']
Нету слова 琼屑碎玉 | ['qióngxiè suìyù', '[ref]碎琼乱玉[/ref]']
Нету слова 石油勘探许可证 | ['shíyóu kāntàn xǔkězhèng', 'лицензия на поиски и разведку нефти и газа']
Нету слова 差别风化 | ['chābié fēnghuà', 'дифференциальное выветривание']
Нету слова 埃科诺姆采夫 | ['āikē’nuòmǔcǎifū', 'Экономцев [i](фамилия)[/i]']
Нету слова 埃科诺莫娃 | ['āikē’nuòmòwá', 'Экономова [i](фамилия)[/i]']
Нету слова 埃克纳季奥相茨 | ['āikè’nàjì’àoxiāngcí', 'Экнадиосянц [i](фамилия)[/i]']
Нету слова 埃克拉森 | ['āikèlāsēn', 'Эклассен [i](фамилия)[/i]']
Нету слова 埃基莫夫 | ['āijīmòfū', 'Экимов [i](фамилия)[/i]']
Нету слова 埃基翁 | ['āijīwēng', 'Экивин [i](фамилия)[/i]']
Нету слова 工资构成 | ['gōngzī gòuchéng', 'структура зарплаты']
Нету слова 埃克津普利亚罗夫 | ['āikèjīnpǔlìyàluófū', 'Экземпляров [i](фамилия)[/i]']
Нету слова 埃克扎尔霍 | ['āikèzā’ěrhuò', 'Экзархо [i](имя', 'фамилия)[/i]']
Нету слова 埃肯布拉特 | ['āikěnbùlātè', 'Экенблат [i](фамилия)[/i]']
Нету слова 埃克贝尔 | ['āikèbèi’ěr', 'Экбер [i](имя)[/i]']
Нету слова 埃卡列娃 | ['āikǎlièwá', 'Экарева [i](фамилия)[/i]']
Нету слова 艾希斯金 | ['àixīsījīn', 'Эйшискин [i](фамилия)[/i]']
Нету слова 艾申斯基娅 | ['àishēnsījīyà', 'Эйшинская [i](фамилия)[/i]']
Нету слова 艾希勒 | ['àixīlè', 'Эйхлер [i](фамилия)[/i]']
Нету слова 埃克萨诺娃 | ['āikèsà’nuòwá', 'Эксанова [i](фамилия)[/i]']
Нету слова 埃克斯特勒姆 | ['āikèsītèlèmǔ', 'Экстрем [i](фамилия)[/i]']
Нету слова 埃克斯特罗娃 | ['āikèsītèluówá', 'Экстрова [i](фамилия)[/i]']
Нету слова 埃克托娃 | ['āikètuōwá', 'Эктова [i](фамилия)[/i]']
Нету слова 埃克申格尔 | ['āikèshēn’gé’ěr', 'Экшенгер [i](фамилия)[/i]']
Нету слова 埃尔加 | ['āi’ěrjiā', 'Элга', 'Эльга [i](имя)[/i]']
Нету слова 埃尔达尔 | ['āiěrdá’ěr', 'Элдар [i](имя)[/i]']
Нету слова 埃列金 | ['āilièjīn', 'Эледин [i](имя', 'фамилия)[/i]']
Нету слова 埃莱门特 | ['āiláiméntè', 'Элемент [i](фамилия)[/i]']
Нету слова 埃伦布赫 | ['āilúnbùhè', 'Эленбух [i](фамилия)[/i]']
Нету слова 埃伦图赫 | ['āilúntúhè', 'Элентух [i](фамилия)[/i]']
Нету слова 埃列特科 | ['āiliètèkē', 'Элетко [i](фамилия)[/i]']
Нету слова 埃利阿瓦 | ['āilì’āwǎ', 'Элиава [i](фамилия)[/i]']
Нету слова 埃利阿索娃 | ['āilì’āsuǒwá', 'Элиасова [i](фамилия)[/i]']
Нету слова 唐松毛茛属 | ['tángsōng máogèn shǔ', 'род траутфеттерия [i](лат. Trautvetteria)[/i]']
Нету слова 唐松毛茛 | ['_', 'Trautvetteria palmata']
Нету слова 扁距木属 | ['biǎnjùmù shǔ', '[ref]安神木属[/ref]']
Нету слова 帕米尔糖芥 | ['pàmǐ’ěr tángjiè', 'желтушник алайский [i](лат. Erysimum alaicum)[/i]']
Нету слова 沙漠糖芥 | ['shāmò tángjiè', 'желтушник Черняева [i](лат. Erysimum czernjajevii)[/i]']
Нету слова 阿尔泰糖芥 | ['ā’ěrtài tángjiè', 'желтушник алтайский [i](лат. Erysimum flavum subsp. altaicum)[/i]']
Нету слова 厚果糖芥 | ['_', 'Erysimum pachycarpum']
Нету слова 粗壮糖芥 | ['_', 'Erysimum robustum']
Нету слова 帚枝糖芥 | ['zhǒuzhī tángjiè', 'желтушник лозный [i](лат. Erysimum virgatum)[/i]']
Нету слова 银毛棱果芥 | ['_', 'Erysimum mongolicum']
Нету слова 斜入射干涉仪 | ['xiérùshè gānshèyí', 'интерферометр наклонного падения']
Нету слова 黑鸟式侦察机 | ['hēiniǎoshì zhēnchájī', '«Чёрный дрозд»', 'Lockheed SR-71 [i](стратегический сверхзвуковой самолёт-разведчик ВВС США)[/i]']
Нету слова 西风号无人机 | ['xīfēnghào wúrénjī', 'беспилотный летательный аппарат Зефир']
Нету слова 宇航环境公司 | ['yǔháng huánjìng gōngsī', 'Аэровайронмент', 'AeroVironment [i](американский оборонный подрядчик)[/i]']
Нету слова 恒位油杯 | ['héngwèi yóubēi', 'маслёнка постоянного уровня', 'МПУ']
Нету слова 俄罗斯联邦国旗日 | ['éluósī liánbāng guóqírì', 'День Государственного флага Российской Федерации ([i]22 августа[/i])']
Нету слова 埃利博 | ['āilìbó', 'Элибо [i](имя', 'фамилия)[/i]']
Нету слова 伊丽莎 | ['yīlìshā', 'Элиза [i](имя)[/i]']
Нету слова 耶利扎罗夫 | ['yēlìzāluófū', 'Елизаров [i](фамилия)[/i]']
Нету слова 埃利兹巴尔 | ['āilìzībā’ěr', 'Элизбар [i](имя собственное)[/i]']
Нету слова 埃利姆 | ['āilìmǔ', 'Элим [i](имя)[/i]']
Нету слова 埃林松 | ['āilínsōng', 'Элинсон [i](фамилия)[/i]']
Нету слова 埃利萨什维利 | ['āilìsàshíwéilì', 'Элисашвили [i](фамилия)[/i]']
Нету слова 埃尔科宁 | ['āi’ěrkē’níng', 'Элконин [i](фамилия)[/i]']
Нету слова 埃拉季 | ['āilājì', 'Элладий [i](имя)[/i]']
Нету слова 埃兰斯基 | ['āilánsījī', 'Элланский [i](фамилия)[/i]']
Нету слова 埃伦戈恩 | ['āilúngē’ēn', 'Элленгорн [i](фамилия)[/i]']
Нету слова 埃勒斯 | ['āilèsī', 'Эллерс [i](фамилия)[/i]']
Нету слова 埃洛什维利 | ['āiluòshíwéilì', 'Элошвили [i](фамилия)[/i]']
Нету слова 埃林斯基娅 | ['āilínsījīyà', 'Эллинская [i](фамилия)[/i]']
Нету слова 金刚捣碓 | ['jīngāng dǎoduì', 'Богатырь толчёт в ступе ([i]вторая форма комплекса тайцзи-цюаня стиля Чэнь[/i])']
Нету слова 周期蛋白依赖性激酶 | ['zhōuqī dànbái yīlàixìng jīméi', 'циклинзависимые киназы ([i]группа белков[/i])']
Нету слова 二苯基氰化胂 | ['èrběnjī qínghuà shèn', 'дифенилцианарсин ([i]отравляющее вещество[/i])']
Нету слова 埃尔皮金娜 | ['āi’ěrpíjīnnà', 'Элпидина [i](фамилия)[/i]']
Нету слова 把门卸下来 | ['bǎmén xièxiàlái', 'снимать/срывать дверь с петель']
Нету слова 埃尔贝特 | ['āi’ěrbèitè', 'Эльберт [i](фамилия)[/i]']
Нету слова 埃利布斯基 | ['āilìbùsījī', 'Эльбуский [i](фамилия)[/i]']
Нету слова 埃莉维拉 | ['āilìwéilā', 'Эльвира [i](имя)[/i]']
Нету слова 埃尔戈特 | ['āi’ěrgētè', 'Эльгорт [i](фамилия)[/i]']
Нету слова 埃利达罗夫 | ['āilìdáluófū', 'Эльдаров [i](фамилия)[/i]']
Нету слова 埃利达尔哈罗夫 | ['āilìdá’ěrhāluófū', 'Эльдархаров [i](фамилия)[/i]']
Нету слова 埃尔扎 | ['āi’ěrzā', 'Эльза [i](имя)[/i]']
Нету слова 制宪议会 | ['zhìxiàn yìhuì', 'учредительное собрание']
Нету слова 负鼠目 | ['fùshǔ mù', 'опоссумы ([i]Didelphimorphia', 'отряд сумчатых[/i])']
Нету слова kb | ['_', '口爆']
Нету слова 瓦根克内希特 | ['wǎgēnkè’nèixītè', 'Вагенкнехт [i](фамилия)[/i]']
Нету слова 热泵浦激光器 | ['rèbèngpǔ jīguāngqì', 'лазер с тепловой накачкой']
Нету слова 随动激光器 | ['suídòng jīguāngqì', 'лазер', 'синхронизированный внешним сигналом']
Нету слова 基模激光器 | ['jīmó jīguāngqì', 'лазер', 'генерирующий на основной моде']
Нету слова 透镜阵列 | ['tòujìng zhènliè', 'линзовая матрица', 'линзовый растр']
Нету слова 水中萧 | ['_', 'минет в душе']
Нету слова 环保降温 | ['huánbǎo jiàngwēn', 'экологически чистое охлаждение']
Нету слова 外缸套 | ['_', 'внешняя гильза цилиндра']
Нету слова 氢分子离子 | ['qīngfēnzǐ lízǐ', 'молекулярный ион водорода']
Нету слова 彭宁阱 | ['péngníngjǐng', 'ловушка Пеннинга']
Нету слова 密录器 | ['mìlùqì', 'устройство скрытой аудио-видеозаписи']
Нету слова 轮刃 | ['lúnrèn', '[ref]环刃[/ref]']
Нету слова 圆月轮 | ['yuányuèlún', '[ref]环刃[/ref]']
Нету слова 至尊巴斯军事勋章 | ['zhìzūn bāsī jūnshì xūnzhāng', '[ref]最尊贵的巴斯勋章[/ref]']
Нету слова 埃尔金德 | ['āi’ěrjīndé', 'Элькинд [i](фамилия)[/i]']
Нету слова 埃利科宁 | ['āilìkē’níng', 'Эльконин [i](фамилия)[/i]']
Нету слова 埃利马诺夫 | ['āilìmǎ’nuòfū', 'Эльманов [i](фамилия)[/i]']
Нету слова 埃尔马尔 | ['āi’ěrmǎ’ěr', 'Эльмар [i](имя)[/i]']
Нету слова 埃尔穆尔扎 | ['āi’ěrmù’ěrzā', 'Эльмурза [i](имя)[/i]']
Нету слова 埃尔佩林娜 | ['āi’ěrpèilínnà', 'Эльперина [i](фамилия)[/i]']
Нету слова 埃尔斯贝格 | ['āi’ěrsībèigé', 'Эльсберг [i](фамилия)[/i]']
Нету слова 埃尔斯尼茨 | ['āi’ěrsīnící', 'Эльсниц [i](фамилия)[/i]']
Нету слова 埃尔特曼 | ['āi’ěrtèmàn', 'Эльтерман [i](фамилия)[/i]']
Нету слова 埃利图金 | ['āilìtújīn', 'Эльтудин [i](фамилия)[/i]']
Нету слова 埃尔弗里达 | ['āi’ěrfúlǐdá', 'Эльфрида [i](имя)[/i]']
Нету слова 埃尔霍内斯 | ['āi’ěrhuònèisī', 'Эльхонес [i](фамилия)[/i]']
Нету слова 埃利奇别科娃 | ['āilìqíbiékēwá', 'Эльчибекова [i](фамилия)[/i]']
Нету слова 埃利奇帕罗娃 | ['āilìqípàluówá', 'Эльчипарова [i](фамилия)[/i]']
Нету слова 埃尔什拉普 | ['āi’ěrshílāpǔ', 'Эльшрап [i](фамилия)[/i]']
Нету слова 埃利亚诺娃 | ['āilìyà’nuòwá', 'Эльянова [i](фамилия)[/i]']
Нету слова 埃利亚舍夫 | ['āilìyàshèfū', 'Эльяшев [i](фамилия)[/i]']
Нету слова 埃柳耶娃 | ['āiliǔyēwá', 'Элюева [i](фамилия)[/i]']
Нету слова 埃马诺娃 | ['āimǎ’nuòwá', 'Эманова [i](фамилия)[/i]']
Нету слова 埃姆金娜 | ['āimǔjīnnà', 'Эмдина [i](фамилия)[/i]']
Нету слова 埃梅利金娜 | ['āiméilìjīnnà', 'Эмельдина [i](фамилия)[/i]']
Нету слова 埃梅罗娃 | ['āiméiluówá', 'Эмерова [i](фамилия)[/i]']
Нету слова 埃姆津娜 | ['āimǔjīnnà', 'Эмзина [i](фамилия)[/i]']
Нету слова 埃米利 | ['āimǐlì', 'Эмилий [i](имя)[/i]']
Нету слова 埃米利耶夫 | ['āimǐlìyēfū', 'Эмильев [i](фамилия)[/i]']
Нету слова 埃明娜 | ['āimíngnà', 'Эмина [i](имя)[/i]']
Нету слова 埃米罗夫 | ['āimǐluófū', 'Эмиров [i](фамилия)[/i]']
Нету слова 埃姆库尔 | ['āimǔkù’ěr', 'Эмкуль [i](фамилия)[/i]']
Нету слова 埃梅里希 | ['āiméilǐxī', 'Эммерих [i](фамилия)[/i]']
Нету слова 埃莫莫娃 | ['āimòmòwá', 'Эмомова [i](фамилия)[/i]']
Нету слова 恩贝格 | ['ēnbèigé', 'Энберг [i](фамилия)[/i]']
Нету слова 恩格尔克龙 | ['ēngé’ěrkèlóng', 'Энгелькрон [i](фамилия)[/i]']
Нету слова 恩格斯贝格 | ['ēngésībèigé', 'Энгельсберг [i](фамилия)[/i]']
Нету слова 桶形座椅 | ['tǒngxíng zuòyǐ', 'ковшеобразное сиденье']
Нету слова 恩格列济 | ['ēngélièjì', 'Энглези [i](фамилия)[/i]']
Нету слова 恩戈瓦托夫 | ['ēngēwǎtuōfū', 'Энговатов [i](фамилия)[/i]']
Нету слова 恩格连 | ['ēngélián', 'Энгрен [i](фамилия)[/i]']
Нету слова 恩杰夫 | ['ēnjiéfū', 'Эндев [i](фамилия)[/i]']
Нету слова 恩杰林 | ['ēnjiélín', 'Энделин [i](фамилия)[/i]']
Нету слова 恩德林娜 | ['ēndélínnà', 'Эндлина [i](фамилия)[/i]']
Нету слова 恩泽林 | ['ēnzélín', 'Эндзелин [i](фамилия)[/i]']
Нету слова 恩泽利斯 | ['ēnzélìsī', 'Эндзелис [i](фамилия)[/i]']
Нету слова 恩德鲁普 | ['ēndélǔpǔ', 'Эндруп [i](фамилия)[/i]']
Нету слова 埃内迪 | ['āinèidí', 'Энеди [i](фамилия)[/i]']
Нету слова 埃涅耶娃 | ['āinièyēwá', 'Энеева [i](фамилия)[/i]']
Нету слова 恩克尔 | ['ēnkè’ěr', 'Энкель [i](фамилия)[/i]']
Нету слова 恩克勒 | ['ēnkèlè', 'Энклер [i](фамилия)[/i]']
Нету слова 恩纳茨基 | ['ēnnàcíjī', 'Эннатский [i](фамилия)[/i]']
Нету слова 恩尼特 | ['ēnnítè', 'Энните [i](имя)[/i]']
Нету слова 埃诺金娜 | ['āinuòjīnnà', 'Энодина [i](фамилия)[/i]']
Нету слова 恩斯基娅 | ['ēnsījīyà', 'Энская [i](фамилия)[/i]']
Нету слова 恩滕松 | ['ēnténgsōng', 'Энтензон [i](фамилия)[/i]']
Нету слова 恩蒂斯 | ['ēndìsī', 'Энтис [i](фамилия)[/i]']
Нету слова 角度光谱 | ['jiǎodù guāngpǔ', 'угловой спектр']
Нету слова 俄歇能谱 | ['éxiē néngpǔ', 'оже-электронный спектр']
Нету слова 自电离光谱 | ['zìdiànlí guāngpǔ', 'спектр автоионизации']
Нету слова 绝对黑体辐射谱 | ['juéduì hēitǐ fúshèpǔ', 'спектр абсолютно чёрного тела']
Нету слова 恩施泰因 | ['ēnshītàiyīn', 'Энштейн [i](фамилия)[/i]']
Нету слова 埃帕米农多维奇 | ['āipàmǐ’nóngduōwéiqí', 'Эпаминондович [i](фамилия)[/i]']
Нету слова 迄小 | ['qìxiǎo', '[ref]迄小儿[/ref]']
Нету слова 毛叶糖蜜草 | ['máoyè tángmìcǎo', '[ref]卷叶红毛草[/ref]']
Нету слова 黑穗红毛草 | ['_', 'Melinis repens subsp. nigricans']
Нету слова 大桃花桂 | ['_', 'Kalmiopsis fragrans']
Нету слова 水条柿属 | ['_', 'род Royena']
Нету слова 水条柿 | ['_', 'Royena lucida']
Нету слова 矮桃花心木 | ['_', 'Swietenia humilis']
Нету слова 狭叶桃金茶 | ['_', 'Archytaea angustifolia']
Нету слова 桃心榄属 | ['táoxīnlǎn shǔ', 'род окуме [i](лат. Aucoumea)[/i]']
Нету слова 陶氏苔 | ['_', 'Treubia insignis']
Нету слова 套唇苣苔 | ['_', 'Damrongia purpureolineata']
Нету слова 套冠菊 | ['_', 'Dimerostemma brasilianum']
Нету слова 异色藤槐 | ['_', 'Bowringia discolor']
Нету слова 金皮山竹 | ['_', 'Garcinia humilis']
Нету слова 栋膏树 | ['_', 'Garcinia oleosperma']
Нету слова 喙藤黄 | ['_', 'Garcinia rostrata']
Нету слова 酸云果 | ['suānyúnguǒ', 'гарциния камбоджийская [i](лат. Garcinia gummi-gutta)[/i]']
Нету слова 书带藤黄 | ['_', 'Garcinia mungotia']
Нету слова 藤菊属 | ['téngjú shǔ', 'род циссампелопсис [i](лат. Cissampelopsis)[/i]']
Нету слова 腺毛藤菊 | ['_', 'Cissampelopsis glandulosa']
Нету слова 中华藤蕨 | ['_', 'Lomariopsis chinensis']
Нету слова 花楸叶藤蕨 | ['_', 'Lomariopsis sorbifolia']
Нету слова 中亚木藤蓼 | ['zhōngyà mùténgliǎo', 'гречишка бальджуанская', 'горец бальджуанский [i](лат. Fallopia baldschuanica)[/i]']
Нету слова 疏花篱蓼 | ['_', 'Fallopia dumetorum var. pauciflora']
Нету слова 藤蓼 | ['téngliǎo', 'гречишка лазающая [i](лат. Fallopia scandens)[/i]']
Нету слова 蔓首乌 | ['mànshǒuwū', '[ref]卷茎蓼[/ref]']
Нету слова 华蔓首乌 | ['_', 'Fallopia forbesii']
Нету слова 芮草 | ['ruìcǎo', '[ref]何首乌[/ref]']
Нету слова 灰岩猩红藤珊豆 | ['_', 'Kennedia coccinea subsp. calcaria']
Нету слова 黑花藤珊豆 | ['_', 'Kennedia nigricans']
Нету слова 囊果藤珊豆 | ['_', 'Kennedia stirlingii']
Нету слова 藤尾菊属 | ['_', 'род Humbertacalia']
Нету слова 显脉藤尾菊 | ['_', 'Humbertacalia abbreviata']
Нету слова 毛叶藤尾菊 | ['_', 'Humbertacalia coursii']
Нету слова 齿叶藤尾菊 | ['_', 'Humbertacalia neoalleizettei']
Нету слова 藤尾菊 | ['_', 'Humbertacalia tomentosa']
Нету слова 五蕊阳桃 | ['_', 'Dapania pentandra']
Нету слова 海南藤芋 | ['_', 'Scindapsus maclurei']
Нету слова 药用藤芋 | ['_', 'Scindapsus officinalis']
Нету слова 梯翅蓬属 | ['tīchìpéng shǔ', 'род климакоптера [i](лат. Climacoptera)[/i]']
Нету слова 梯翅蓬 | ['tīchìpéng', 'климакоптера шерстистая', 'солянка шерстистая [i](лат. Climacoptera lanata)[/i]']
Нету слова 粗枝梯翅蓬 | ['cūzhī tīchìpéng', 'климакоптера толстоватая', 'солянка толстоватая [i](лат. Climacoptera subcrassa)[/i]']
Нету слова 二药梯牧草 | ['_', 'Phleum crypsoides']
Нету слова 工作打卡考核 | ['gōngzuò dǎkǎ kǎohé', 'система учёта рабочего времени']
Нету слова 变色提灯藓 | ['biànsè tídēngxiǎn', 'мниум Блютта [i](лат. Mnium blyttii)[/i]']
Нету слова 平肋提灯藓 | ['_', 'Mnium laevinerve']
Нету слова 具缘提灯藓 | ['jùyuán tídēngxiǎn', 'мниум окаймлённый [i](лат. Mnium marginatum)[/i]']
Нету слова 硬叶提灯藓 | ['yìngyè tídēngxiǎn', 'мниум звёздчатый [i](лат. Mnium stellare)[/i]']
Нету слова 嘴努子 | ['_', 'надутые губы', 'обиженная мордочка [i](о подусниках)[/i]']
Нету слова 希陶蹄盖蕨 | ['_', 'Athyrium dentigerum']
Нету слова 短羽蹄盖蕨 | ['_', 'Athyrium contingens']
Нету слова 疏羽蹄盖蕨 | ['_', 'Athyrium nephrodioides']
Нету слова 日光蹄盖蕨 | ['_', 'Athyrium nikkoense']
Нету слова 高寒蹄盖蕨 | ['gāohán tígàijué', 'кочедыжник скальный [i](лат. Athyrium rupestre)[/i]']
Нету слова 睫毛盖假冷蕨 | ['_', 'Athyrium schizochlamys']
Нету слова 阿墩子假冷蕨 | ['_', 'Athyrium atuntzeense']
Нету слова 腺毛蹄盖蕨 | ['_', 'Athyrium glandulosum']
Нету слова 喜马拉雅蹄盖蕨 | ['_', 'Athyrium fimbriatum']
Нету слова 红苞蹄盖蕨 | ['_', 'Athyrium nakanoi']
Нету слова 贞丰蹄盖蕨 | ['_', 'Athyrium zhenfengense']
Нету слова 疏叶蹄盖蕨 | ['_', 'Athyrium dissitifolium var. dissitifolium']
Нету слова 无盖蹄盖蕨 | ['_', 'Athyrium exindusiatum']
Нету слова 假冷蕨 | ['jiǎlěngjué', 'ложнопузырник игольчатый', 'кочедыжник игольчатый [i](лат. Athyrium spinulosum)[/i]']
Нету слова 狭基蹄盖蕨 | ['_', 'Athyrium mehrae']
Нету слова 长叶蹄盖蕨 | ['_', 'Athyrium elongatum']
Нету слова 瘦叶蹄盖蕨 | ['_', 'Athyrium deltoidofrons var. gracillimum']
Нету слова 湿生蹄盖蕨 | ['_', 'Athyrium devolii']
Нету слова 尖头蹄盖蕨 | ['jiāntóu tígàijué', 'кочедыжник Видаля [i](лат. Athyrium vidalii var. vidalii)[/i]']
Нету слова 薄叶蹄盖蕨 | ['_', 'Athyrium delicatulum']
Нету слова 川西蹄盖蕨 | ['_', 'Athyrium costulalisorum']
Нету слова 毛轴蹄盖蕨 | ['_', 'Athyrium hirtirachis']
Нету слова 狭叶蹄盖蕨 | ['_', 'Athyrium flabellulatum']
Нету слова 宝兴蹄盖蕨 | ['_', 'Athyrium baoxingense']
Нету слова 毛叶蹄盖蕨 | ['_', 'Athyrium suprapuberulum']
Нету слова 中甸蹄盖蕨 | ['_', 'Athyrium chungtienense']
Нету слова 小叶蹄盖蕨 | ['_', 'Athyrium leiopodum']
Нету слова 中越蹄盖蕨 | ['_', 'Athyrium christensenii']
Нету слова 柄羽蹄盖蕨 | ['_', 'Athyrium sessilipinnum']
Нету слова 方氏蹄盖蕨 | ['_', 'Athyrium fangii']
Нету слова 俞氏蹄盖蕨 | ['_', 'Athyrium yui']
Нету слова 鹿角蹄盖蕨 | ['_', 'Athyrium araiostegioides']
Нету слова 黑柄蹄盖蕨 | ['_', 'Athyrium nigripes']
Нету слова 川黔蹄盖蕨 | ['_', 'Athyrium iseanum var. chuanqianense']
Нету слова 无毛华中蹄盖蕨 | ['_', 'Athyrium wardii var. glabratum']
Нету слова 坡生蹄盖蕨 | ['_', 'Athyrium clivicola var. clivicola']
Нету слова 光蹄盖蕨 | ['_', 'Athyrium otophorum']
Нету слова 福贡蹄盖蕨 | ['_', 'Athyrium roseum var. fugongense']
Нету слова 粗脉蹄盖蕨 | ['_', 'Athyrium venulosum']
Нету слова 姬蹄盖蕨 | ['_', 'Athyrium subrigescens']
Нету слова 仓田蹄盖蕨 | ['_', 'Athyrium kuratae']
Нету слова 金平蹄盖蕨 | ['_', 'Athyrium adpressum']
Нету слова 墨脱蹄盖蕨 | ['_', 'Athyrium medogense']
Нету слова 高山蹄盖蕨 | ['_', 'Athyrium silvicola']
Нету слова 南岳蹄盖蕨 | ['_', 'Athyrium nanyueense']
Нету слова 脆蹄盖蕨 | ['_', 'Athyrium frangulum']
Нету слова 高超蹄盖蕨 | ['_', 'Athyrium excelsius']
Нету слова 黑合蹄盖蕨 | ['_', 'Athyrium × pseudocryptogrammoides']
Нету слова 库氏天鹅兰 | ['kùshì tiān’élán', '[ref]粗指天鹅兰[/ref]']
Нету слова 天凤花 | ['_', 'Erythrostemon gilliesii']
Нету слова 爪哇天胡荽 | ['_', 'Hydrocotyle javanica']
Нету слова 姬天胡荽 | ['_', 'Hydrocotyle yabei']
Нету слова 漂浮天胡荽 | ['_', 'Hydrocotyle ranunculoides']
Нету слова 不要B脸 | ['_', '[ref]不要脸[/ref]']
Нету слова 蜡烛冥想 | ['làzhú míngxiǎng', 'медитация на пламя свечи', 'тратака']
Нету слова 撞生光谱 | ['zhuàngshēng guāngpǔ', 'спектр', 'индуцированный столкновениями']
Нету слова 自然光谱 | ['zìrán guāngpǔ', 'спектр дневного света']
Нету слова 天马楝 | ['tiānmǎliàn', 'энтандрофрагма ангольская', 'тиама [i](лат. Entandrophragma angolense)[/i]']
Нету слова 柱果天马楝 | ['zhùguǒ tiānmǎliàn', 'энтандрофрагма цилиндрическая', 'сапеле [i](лат. Entandrophragma cylindricum)[/i]']
Нету слова 无多普勒光谱 | ['wúduōpǔlè guāngpǔ', 'бездоплеровский спектр']
Нету слова 叶门冬 | ['_', 'Asparagus asparagoides']
Нету слова 山文竹 | ['_', 'Asparagus acicularis']
Нету слова 折枝天门冬 | ['zhézhī tiānméndōng', 'спаржа угловатонадломанная', 'спаржа джунгарская [i](лат. Asparagus angulofractus)[/i]']
Нету слова 大别山天门冬 | ['_', 'Asparagus dabieshanensis']
Нету слова 非洲武竹 | ['fēizhōu wǔzhú', '[ref]非洲天门冬[/ref]']
Нету слова 戈壁天门冬 | ['_', 'Asparagus gobicus']
Нету слова 长花天门冬 | ['_', 'Asparagus longiflorus']
Нету слова 昆明天门冬 | ['_', 'Asparagus mairei']
Нету слова 西南天门冬 | ['_', 'Asparagus munitus']
Нету слова 北天门冬 | ['_', 'Asparagus przewalskyi']
Нету слова 四川天门冬 | ['_', 'Asparagus sichuanicus']
Нету слова 西藏天门冬 | ['_', 'Asparagus tibeticus']
Нету слова 毛叶天冬 | ['_', 'Asparagus trichophyllus var. trachyphyllus']
Нету слова 烟管头草 | ['yānguǎntóucǎo', 'карпезиум поникающий', 'карпезий поникающий', 'карпезиум поникший [i](лат. Carpesium cernuum)[/i]']
Нету слова 天蓬子属 | ['tiānpéngzǐ shǔ', 'род атропанте [i](лат. Atropanthe)[/i]']
Нету слова 非洲泽芹 | ['_', 'Berula imbricata']
Нету слова 天梯蕨属 | ['_', 'род Jamesonia']
Нету слова 硬毛栗发蕨 | ['_', 'Jamesonia hispidula']
Нету слова 密花天仙藤 | ['_', 'Fibraurea darshanii']
Нету слова 崖莨菪 | ['_', 'Hyoscyamus leptocalyx']
Нету слова 天星蕨 | ['_', 'Christensenia aesculifolia']
Нету слова 羽衣天竺葵 | ['_', 'Pelargonium alchemilloides']
Нету слова 玉人葵 | ['yùrénkuí', 'пеларгония мясистая [i](лат. Pelargonium carnosum)[/i]']
Нету слова 埃佩尔曼 | ['āipèi’ěrmàn', 'Эпельман [i](фамилия)[/i]']
Нету слова 埃皮克 | ['āipíkè', 'Эпик [i](фамилия)[/i]']
Нету слова 危地马拉铁兰 | ['_', 'Tillandsia guatemalensis']
Нету слова 埃皮库尔 | ['āipíkù’ěr', 'Эпикур [i](имя)[/i]']
Нету слова 埃平娜 | ['āipíngnà', 'Эпина [i](фамилия)[/i]']
Нету слова 埃皮尔金娜 | ['āipí’ěrjīnnà', 'Эпилкина [i](фамилия)[/i]']
Нету слова 埃皮特尔恩 | ['āipítè’ěr’ēn', 'Эпительн [i](фамилия)[/i]']
Нету слова 埃平格 | ['āipínggé', 'Эппингер [i](фамилия)[/i]']
Нету слова 埃普费尔包姆 | ['āipǔfèi’ěrbāomǔ', 'Эпфельбаум [i](фамилия)[/i]']
Нету слова 埃拉兹穆斯 | ['āilāzīmùsī', 'Эразмус [i](имя)[/i]']
Нету слова 阿拉克 | ['ālākè', 'Арак [i](город в Иране)[/i]']
Нету слова 埃兰斯 | ['āilánsī', 'Эранс [i](фамилия)[/i]']
Нету слова 埃拉西 | ['āilāxī', 'Эрасси [i](фамилия)[/i]']
Нету слова 埃拉斯托娃 | ['āilāsītuōwá', 'Эрастова [i](фамилия)[/i]']
Нету слова 埃拉托娃 | ['āilātuōwá', 'Эратова [i](фамилия)[/i]']
Нету слова 埃贝斯 | ['āibèisī', 'Эрбес [i](фамилия)[/i]']
Нету слова 埃尔维佐夫 | ['āi’ěrwéizuǒfū', 'Эрвицов [i](фамилия)[/i]']
Нету слова 埃尔维耶 | ['āi’ěrwéiyē', 'Эрвье [i](фамилия)[/i]']
Нету слова 埃尔加什博伊 | ['āi’ěrjiāshíbóyī', 'Эргашбой [i](имя)[/i]']
Нету слова 紫花凤梨 | ['zǐhuā fènglí', '[ref]铁兰[/ref]']
Нету слова 埃尔格什 | ['āi’ěrgéshí', 'Эргеш [i](имя)[/i]']
Нету слова 埃尔吉勒 | ['āi’ěrjílè', 'Эргилер [i](фамилия)[/i]']
Нету слова 埃尔格利斯 | ['āi’ěrgélìsī', 'Эрглис [i](фамилия)[/i]']
Нету слова 埃德曼 | ['āidémàn', 'Эрдман [i](фамилия)[/i]']
Нету слова 埃尔德涅耶夫斯基 | ['āi’ěrdénièyēfūsījī', 'Эрдынеевский [i](фамилия)[/i]']
Нету слова 埃列卡耶夫 | ['āilièkǎyēfū', 'Эрекаев [i](фамилия)[/i]']
Нету слова 埃伦格罗斯 | ['āilúngéluósī', 'Эренгросс [i](фамилия)[/i]']
Нету слова 埃伦菲尔德 | ['āilúnfēi’ěrdé', 'Эренфельд [i](фамилия)[/i]']
Нету слова 埃尔兹利坎 | ['āi’ěrzīlìkǎn', 'Эрзликан [i](имя собственное)[/i]']
Нету слова 埃尔万采夫 | ['āi’ěrwàncǎifū', 'Эрванцев [i](фамилия)[/i]']
Нету слова 埃里卡耶夫 | ['āilǐkǎyēfū', 'Эрикаев [i](фамилия)[/i]']
Нету слова 埃里金娜 | ['āilǐjīnnà', 'Эрикина [i](фамилия)[/i]']
Нету слова 埃里斯 | ['āilǐsī', 'Эрис [i](имя)[/i]']
Нету слова 埃里斯托夫 | ['āilǐsītuōfū', 'Эристов [i](фамилия)[/i]']
Нету слова 埃尔卡拜 | ['āi’ěrkǎbài', 'Эркабай [i](имя)[/i]']
Нету слова 埃尔金拜 | ['āi’ěrjīnbài', 'Эркинбай [i](имя)[/i]']
Нету слова 埃尔列克索娃 | ['āi’ěrlièkèsuǒwá', 'Эрлексова [i](фамилия)[/i]']
Нету слова 埃尔利茨基 | ['āi’ěrlìcíjī', 'Эрлицкий [i](фамилия)[/i]']
Нету слова 埃曼斯 | ['āimànsī', 'Эрманс [i](фамилия)[/i]']
Нету слова 埃尔纳扎罗娃 | ['āi’ěrnàzāluówá', 'Эрназарова [i](фамилия)[/i]']
Нету слова 埃尔纳尼 | ['āi’ěrnà’ní', 'Эрнани [i](имя)[/i]']
Нету слова 不完全性雄激素不敏感综合征 | ['bù wánquánxìng xióngjīsù bùmǐngǎn zōnghézhēng', 'синдром неполной андрогенной нечувствительности']
Нету слова 弧光光谱 | ['húguāng guāngpǔ', 'дуговой спектр']
Нету слова 企者不立，跨者不行 | ['qǐzhě bú lì', 'kuàzhě bù xíng', 'Стоящий на цыпочках долго не простоит', 'делающий (большие', 'быстрые) шаги (далеко) не уйдёт ([i]цитата по 老子[/i])']
Нету слова 多脉天竺香 | ['_', 'Vateria copallifera']
Нету слова 激发态吸收 | ['jīfātài xīshōu', 'возбуждённое поглощение', 'поглощение из возбуждённого состояния']
Нету слова 傅里叶变换光谱 | ['fùlǐyè biànhuàn guāngpǔ', 'фурье-спектр']
Нету слова 花边果甜菜 | ['huābiān’guǒ tiáncài', 'свёкла раздельноплодная [i](лат. Beta lomatogona)[/i]']
Нету слова 蔓生甜菜 | ['_', 'Beta patula']
Нету слова 四倍体铁角蕨 | ['_', 'Asplenium quadrivalens']
Нету слова 匍匐伏石菜 | ['púfú fúshícài', '[ref]小碗花甜菜[/ref]']
Нету слова 甜菜树属 | ['_', 'род Yunnanopilia']
Нету слова 大叶田繁缕 | ['dàyè tiánfánlǚ', 'бергия капская [i](лат. Bergia capensis)[/i]']
Нету слова 伯格草 | ['bógécǎo', '[ref]田繁缕[/ref]']
Нету слова 田花生 | ['_', 'Platypodium elegans']
Нету слова 无毛田菁 | ['wúmáo tiánjīng', 'сесбания рослая [i](лат. Sesbania exaltata)[/i]']
Нету слова 雪亚迪草 | ['xuěyàdícǎo', 'жерардия', 'шерардия [i](лат. Sherardia)[/i]']
Нету слова 条果芥 | ['tiáoguǒjiè', 'паррия арктическая [i](лат. Parrya arctica)[/i]']
Нету слова 柳叶条果芥 | ['liǔyè tiáoguǒjiè', 'паррия ланцетолистная', 'ахорифрагма ланцетолистная', 'нервоплодник ланцетолистный', 'паррия сизолистная [i](лат. Parrya lancifolia)[/i]']
Нету слова 条绒木属 | ['tiáoróngmù shǔ', 'род мишаритера', 'мисхаритера [i](лат. Mischarytera)[/i]']
Нету слова 内气循环 | ['nèiqì xúnhuán', 'циркуляция внутренней ци']
Нету слова 蓧蕨属 | ['diàojué shǔ', 'род олеандра [i](лат. Oleandra)[/i]']
Нету слова 波边蓧蕨 | ['_', 'Oleandra undulata']
Нету слова 调料九里香 | ['tiáoliào jiǔlǐxiāng', 'муррайя Кёнига [i](лат. Murraya koenigii)[/i]']
Нету слова 广西九里香 | ['_', 'Bergera kwangsiensis']
Нету слова 狭果九里香 | ['_', 'Bergera stenocarpa']
Нету слова 贴瓣楝属 | ['_', 'род Turraeanthus']
Нету слова 三叶贴瓣楝 | ['_', 'Turraeanthus mannii']
Нету слова 短柄贴苞宿檐 | ['_', 'Bakoa brevipedunculata']
Нету слова 贵阳铁角蕨 | ['_', 'Asplenium interjectum']
Нету слова 戟叶对开蕨 | ['_', 'Asplenium sagittatum']
Нету слова 对开蕨 | ['_', 'Asplenium komarovii']
Нету слова 苍山蕨 | ['_', 'Asplenium dalhousiae']
Нету слова 独龙江苍山蕨 | ['_', 'Asplenium qiujiangense']
Нету слова 狭翅巢蕨 | ['_', 'Asplenium antrophyoides']
Нету слова 异形铁角蕨 | ['_', 'Asplenium difforme']
Нету слова 台南铁角蕨 | ['_', 'Asplenium trigonopterum']
Нету слова 黑鳞巢蕨 | ['_', 'Asplenium oblanceolatum']
Нету слова 狭鳞巢蕨 | ['_', 'Asplenium grevillei']
Нету слова 厚叶铁角蕨 | ['_', 'Asplenium griffithianum']
Нету слова 羽裂铁角蕨 | ['_', 'Asplenium thunbergii']
Нету слова 膜连铁角蕨 | ['_', 'Asplenium tenerum']
Нету слова 胡萝卜叶铁角蕨 | ['_', 'Asplenium daucifolium']
Нету слова 狭翅铁角蕨 | ['_', 'Asplenium wrightii']
Нету слова 光亮铁角蕨 | ['_', 'Asplenium splendens']
Нету слова 轴孢铁角蕨 | ['_', 'Asplenium friesiorum']
Нету слова 锯齿叶铁角蕨 | ['_', 'Asplenium serratifolium']
Нету слова 江南铁角蕨 | ['_', 'Asplenium holosorum']
Нету слова 毛轴铁角蕨 | ['_', 'Asplenium crinicaule']
Нету слова 合生铁角蕨 | ['_', 'Asplenium adnatum']
Нету слова 棕鳞铁角蕨 | ['_', 'Asplenium yoshinagae']
Нету слова 东南铁角蕨 | ['_', 'Asplenium oldhamii']
Нету слова 瑞丽铁角蕨 | ['_', 'Asplenium rockii']
Нету слова 脂胶芹叶铁角蕨 | ['_', 'Asplenium laserpitiifolium']
Нету слова 裂叶铁角蕨 | ['_', 'Asplenium lobulatum']
Нету слова 匍茎铁角蕨 | ['_', 'Asplenium stoloniferum']
Нету слова 碧凤铁角蕨 | ['_', 'Asplenium pifongiae']
Нету слова 广东铁角蕨 | ['_', 'Asplenium guangdongense']
Нету слова 镰羽铁角蕨 | ['_', 'Asplenium normale f. scythiforme']
Нету слова 腺齿铁角蕨 | ['_', 'Asplenium glanduliserrulatum']
Нету слова 叉叶铁角蕨 | ['chāyè tiějiǎojué', 'костенец северный [i](лат. Asplenium septentrionale)[/i]']
Нету слова 泉生铁角蕨 | ['quánshēng tiějiǎojué', 'костенец ключевой [i](лат. Asplenium fontanum subsp. fontanum)[/i]']
Нету слова 北美过山蕨 | ['_', 'Asplenium rhizophyllum']
Нету слова 漏做 | ['lòu zuò', 'пропустить', 'не выполнить']
Нету слова 不吸收性 | ['bùxīshōuxìng', '1) непоглощающий2) нерассасывающийся']
Нету слова 细茎 | ['xìjīng', 'тонкий стебель', 'тонкостебельный']
Нету слова 钝齿铁角蕨 | ['_', 'Asplenium tenuicaule var. subvarians']
Нету слова 广布铁角蕨 | ['_', 'Asplenium anogrammoides']
Нету слова 云南铁角蕨 | ['yúnnán tiějiǎojué', 'костенец юннаньский [i](лат. Asplenium yunnanense)[/i]']
Нету слова 叶基宽铁角蕨 | ['_', 'Asplenium pulcherrimum']
Нету слова 西疆铁角蕨 | ['_', 'Asplenium kukkonenii']
Нету слова 近变异铁角蕨 | ['_', 'Asplenium semivarians']
Нету слова 王氏铁角蕨 | ['_', 'Asplenium × wangii']
Нету слова 哈如铁角蕨 | ['_', 'Asplenium trichomanes var. harovii']
Нету слова 卡克-霍利湖 | ['kǎkè huòlì hú', 'озеро Как-Холь ([i]в республике Тыва', 'Россия[/i])']
Нету слова 空气草 | ['kōngqìcǎo', '[ref]铁兰[/ref]']
Нету слова 褶丝凤梨 | ['_', 'Tillandsia stricta']
Нету слова 勾苞铁兰 | ['_', 'Tillandsia andreana']
Нету слова 伯格铁兰 | ['_', 'Tillandsia bergeri']
Нету слова 珠芽铁兰 | ['_', 'Tillandsia bulbosa']
Нету слова 树猴铁兰 | ['shùhóu tiělán', '[ref]猴凤梨[/ref]']
Нету слова 喷泉铁兰 | ['_', 'Tillandsia exserta']
Нету слова 歧花铁兰 | ['_', 'Tillandsia flabellata']
Нету слова 白毛铁兰 | ['_', 'Tillandsia fuchsii']
Нету слова 章鱼铁兰 | ['zhāngyú tiělán', '[ref]精灵凤梨[/ref]']
Нету слова 粗鳞铁兰 | ['_', 'Tillandsia paleacea']
Нету слова 斯普伦铁兰 | ['_', 'Tillandsia sprengeliana']
Нету слова 多花铁兰 | ['_', 'Tillandsia turneri var. orientalis']
Нету слова 天鹅绒铁兰 | ['_', 'Tillandsia velutina']
Нету слова 铁木豆 | ['_', 'Swartzia guianensis']
Нету слова 铁青树属 | ['tiěqīngshù shǔ', 'род олакс (лат. Olax)']
Нету слова 垂枝铁青树 | ['_', 'Olax pendula']
Нету слова 鹰爪铁青树 | ['_', 'Olax spartea']
Нету слова 毛叶铁线蕨 | ['_', 'Adiantum hispidulum']
Нету слова 楔叶铁线蕨 | ['xiēyè tiěxiànjué', 'адиантум Радди', 'адиантум клиновидный [i](лат. Adiantum raddianum)[/i]']
Нету слова 深山铁线蕨 | ['_', 'Adiantum formosanum']
Нету слова 肾盖铁线蕨 | ['_', 'Adiantum erythrochlamys']
Нету слова 细辛叶铁线蕨 | ['_', 'Adiantum asarifolium']
Нету слова 单盖 | ['dān’gài', 'однопокровный']
Нету слова 陇南铁线蕨 | ['_', 'Adiantum roborowskii var. roborowskii']
Нету слова 无芒铁线蕨 | ['_', 'Adiantum bonatianum var. subaristatum']
Нету слова 细叶铁线蕨 | ['xìyè tiěxiànjué', 'адиантум очаровательный [i](лат. Adiantum venustum)[/i]']
Нету слова 铁丝草 | ['tiěsīcǎo', '[ref]铁线蕨[/ref]']
Нету слова 银杏蕨 | ['yínxìngjué', '[ref]铁线蕨[/ref]']
Нету слова 半月形铁线蕨 | ['_', 'Adiantum philippense']
Нету слова 小铁线蕨 | ['_', 'Adiantum mariesii']
Нету слова 仙霞铁线蕨 | ['_', 'Adiantum juxtapositum']
Нету слова 倒卵叶铁线蕨 | ['_', 'Adiantum obovatum']
Нету слова 梅山铁线蕨 | ['_', 'Adiantum meishanianum']
Нету слова 多叶铁线蕨 | ['_', 'Adiantum polyphyllum']
Нету слова 秘鲁铁线蕨 | ['_', 'Adiantum peruvianum']
Нету слова 宽叶铁线蕨 | ['_', 'Adiantum latifolium']
Нету слова 光滑铁线蕨 | ['_', 'Adiantum nudum']
Нету слова 向列液晶材料 | ['xiàngliè yèjīng cáiliào', 'нематический жидкокристаллический материал']
Нету слова 架子菜 | ['jiàzicài', '[ref]铁线莲[/ref]']
Нету слова 覆萼铁线莲 | ['_', 'Clematis pimpinellifolia']
Нету слова 白藤铁线莲 | ['báiténg tiěxiànlián', 'ломонос виноградолистный', 'клематис виноградолистный', 'ломонос обыкновенный [i](лат. Clematis vitalba)[/i]']
Нету слова 铁线芹 | ['_', 'Pseudocarum eminii']
Нету слова 铁心菊 | ['_', 'Cloiselia carbonaria']
Нету слова 榄叶铁心菊 | ['_', 'Cloiselia oleifolia']
Нету слова 深红铁心藤 | ['_', 'Metrosideros carminea']
Нету слова 长柔毛铁心木 | ['_', 'Metrosideros collina var. villosa']
Нету слова 桂铁心木 | ['_', 'Metrosideros elegans']
Нету слова 猩红铁心藤 | ['_', 'Metrosideros fulgens']
Нету слова 克马德克铁心木 | ['kèmǎdékè tiěxīnmù', 'метросидерос кермадекский [i](лат. Metrosideros kermadecensis)[/i]']
Нету слова 沼铁心木 | ['_', 'Metrosideros stipularis']
Нету слова 亭阁草属 | ['tínggécǎo shǔ', 'род микрантес', 'камнеломка [i](лат. Micranthes)[/i]']
Нету слова 美花亭阁草 | ['měihuā tínggécǎo', 'камнеломка Мерка', 'камнеломка Мерка мощная', 'камнеломка незабудколистная', 'микрантес Мерка [i](лат. Micranthes merkii subsp. merkii)[/i]']
Нету слова 崖生亭阁草 | ['_', 'Micranthes petiolaris']
Нету слова 黑亭阁草 | ['_', 'Micranthes atrata']
Нету слова 双喙亭阁草 | ['_', 'Micranthes davidii']
Нету слова 道孚亭阁草 | ['_', 'Micranthes lumpuensis']
Нету слова 微亭阁草 | ['_', 'Micranthes parvula']
Нету слова 斑点亭阁草 | ['bāndiǎn tínggécǎo', 'камнеломка Нельсона [i](лат. Micranthes nelsoniana)[/i]']
Нету слова 苣叶亭阁草 | ['_', 'Micranthes micranthidifolia']
Нету слова 雪生亭阁草 | ['xuěshēng tínggécǎo', 'камнеломка снежная', 'камнеломка Ворошилова [i](лат. Micranthes nivalis)[/i]']
Нету слова 修性改命 | ['xiūxìng gǎimìng', 'совершенствуя природу', 'улучшить судьбу']
Нету слова 男塞舌尔人 | ['nánsàishé’ěrrén', 'сейшелец']
Нету слова 银根松紧 | ['yíngēn sōngjǐn', 'жёсткость денежно-кредитной политики']
Нету слова 大西洋庭菖蒲 | ['_', 'Sisyrinchium atlanticum']
Нету слова 百慕大庭菖蒲 | ['bǎimùdà tíngchāngpú', 'голубоглазка бермудская [i](лат. Sisyrinchium bermudiana)[/i]']
Нету слова 山地庭菖蒲 | ['shāndì tíngchāngpú', 'голубоглазка горная', 'сизиринхий горный [i](лат. Sisyrinchium montanum)[/i]']
Нету слова 趋低 | ['qūdī', 'тенденция к снижению']
Нету слова 细叶庭菖蒲 | ['xìyè tíngchāngpú', 'голубоглазка тонколистная [i](лат. Sisyrinchium tenuifolium)[/i]']
Нету слова 莛阳菊属 | ['_', 'род Enceliopsis']
Нету слова 金球庭芥 | ['jīnqiú tíngjiè', 'бурачок Вульфена [i](лат. Alyssum wulfenianum)[/i]']
Нету слова 莛露菊属 | ['tínglùjú shǔ', 'род перезия [i](лат. Perezia)[/i]']
Нету слова 莛露菊 | ['tínglùjú', 'перезия магелланская [i](лат. Perezia magellanica)[/i]']
Нету слова 莛罗芥属 | ['tíngluójiè shǔ', 'род искандера [i](лат. Iskandera)[/i]']
Нету слова 莛明菊 | ['_', 'Robinsonecio gerberifolius']
Нету слова 莛南芥属 | ['_', 'род Scapiarabis']
Нету слова 莛牛菊 | ['_', 'Bechium rubricaule']
Нету слова 银叶莛阳菊 | ['_', 'Enceliopsis argophylla']
Нету слова 莛子藨 | ['tíngzǐbiāo', 'трёхкосточник перистонадрезанный [i](лат. Triosteum pinnatifidum)[/i]']
Нету слова 腋花莛子藨 | ['yèhuā tíngzǐbiāo', 'трёхкосточник выемчатый [i](лат. Triosteum sinuatum)[/i]']
Нету слова 巴格马蒂葶苈 | ['_', 'Draba bagmatiensis']
Нету слова 不丹葶苈 | ['bùdān tínglì', 'крупка бутанская [i](лат. Draba bhutanica)[/i]']
Нету слова 光莛藓状葶苈 | ['guāngtíng xiǎnzhuàng tínglì', 'крупка разногривая [i](лат. Draba bruniifolia subsp. heterocoma)[/i]']
Нету слова 大花葶苈 | ['_', 'Draba cholaensis']
Нету слова 穴丝荠 | ['_', 'Draba draboides']
Нету слова 中亚葶苈 | ['_', 'Draba huetii']
Нету слова 贡布葶苈 | ['_', 'Draba kongboiana']
Нету слова 科氏葶苈 | ['kēshì tínglì', '[ref]塔什库尔干葶苈[/ref]']
Нету слова 木葶苈 | ['_', 'Draba lindenii']
Нету слова 定日葶苈 | ['_', 'Draba mieheorum']
Нету слова 卵果葶苈 | ['_', 'Draba oariocarpa']
Нету слова 奥氏葶苈 | ['àoshì tínglì', '[ref]光梗葶苈[/ref]']
Нету слова 翅丝葶苈 | ['_', 'Draba podolica']
Нету слова 大毛叶葶苈 | ['_', 'Draba sherriffii']
Нету слова 狭果 | ['xiáguǒ', 'узкоплодный']
Нету слова 微柱葶苈 | ['wēizhù tínglì', 'крупка Турчанинова [i](лат. Draba turczaninowii)[/i]']
Нету слова 山荠 | ['shānjì', '[ref]葶苈[/ref]1)']
Нету слова 挺叶苔 | ['_', 'Anastrophyllum donnianum']
Нету слова 深绿挺叶苔 | ['shēnlǜ tǐngyètái', 'кроссокаликс Геллера [i](лат. Crossocalyx hellerianus)[/i]']
Нету слова 尖叶小挺叶苔 | ['_', 'Anastrophyllum minutum var. acuminatum']
Нету слова 毛口挺叶苔 | ['_', 'Anastrophyllum piligerum']
Нету слова 细纹挺叶苔 | ['_', 'Anastrophyllum striolatum']
Нету слова 锥果通肠藤 | ['_', 'Metaporana conica']
Нету слова 小叶通肠藤 | ['_', 'Metaporana parvifolia var. parvifolia']
Нету слова 绵萼通肠藤 | ['_', 'Metaporana parvifolia var. pilosa']
Нету слова 通灵藤 | ['_', 'Banisteriopsis caapi']
Нету слова 早落通泉草 | ['_', 'Mazus caducifer']
Нету слова 灌状通泉草 | ['_', 'Mazus fruticosus']
Нету слова 长柄通泉草 | ['_', 'Mazus henryi']
Нету слова 莲座通泉草 | ['_', 'Mazus lecomtei']
Нету слова 稀花通泉草 | ['_', 'Mazus oliganthus']
Нету слова 美丽通泉草 | ['_', 'Mazus pulchellus']
Нету слова 滇南通泉草 | ['_', 'Mazus pumilus var. wangii']
Нету слова 松岗通泉草 | ['_', 'Mazus songgangensis']
Нету слова 西藏通泉草 | ['_', 'Mazus surculosus']
Нету слова 休宁通泉草 | ['_', 'Mazus xiuningensis']
Нету слова 佛氏通泉草 | ['fóshì tōngquáncǎo', '[ref]台湾通泉草[/ref]']
Нету слова 孙航通泉草 | ['_', 'Mazus sunhangii']
Нету слова 同瓣槐 | ['_', 'Diplotropis martiusii']
Нету слова 同蒴藓属 | ['tóngshuòxiǎn shǔ', 'род гомалотециум', 'гомалотеций [i](лат. Homalothecium)[/i]']
Нету слова 同叶藓属 | ['_', 'род Isopterygium']
Нету слова 华东同叶藓 | ['_', 'Isopterygium courtoisii']
Нету слова 纤枝同叶藓 | ['_', 'Isopterygium minutirameum']
Нету слова 石生同叶藓 | ['_', 'Isopterygium saxense']
Нету слова 羽枝同叶藓 | ['_', 'Isopterygium subpinnatum']
Нету слова 同钟花 | ['_', 'Homocodon brevipes']
Нету слова 彤号木属 | ['tónghàomù shǔ', 'род эизия [i](лат. Eizia)[/i]']
Нету слова 披针叶桐梅 | ['_', 'Kageneckia lanceolata']
Нету слова 歧毛茶属 | ['qímáochá shǔ', 'род тинадендрон [i](лат. Tinadendron)[/i]']
Нету слова 瞳丽木属 | ['_', 'род Tulearia']
Нету слова 童花豆 | ['_', 'Collaea argentina']
Нету слова 加勒比铜绶草 | ['_', 'Mesadenus lucayanus']
Нету слова 火之性 | ['huǒzhīxìng', 'природа огня']
Нету слова 和平利用宇宙空间 | ['hépíng lìyòng yǔzhòu kōngjiān', 'использование космического пространства в мирных целях']
Нету слова 四颜 | ['sìyán', 'четыре лика']
Нету слова 紫水鸡属 | ['zǐshuǐ shǔ', 'султанки ([i]Porphyrio', 'род птиц[/i])']
Нету слова 金背铜铁木 | ['_', 'Cotylelobium burckii']
Нету слова 铜铁木 | ['_', 'Cotylelobium melanoxylon']
Нету слова 铜星蕨 | ['_', 'Hemionitis palmata']
Нету слова 筒萼苔属 | ['tǒng’ètái shǔ', 'род цилиндроколея [i](лат. Cylindrocolea)[/i]']
Нету слова 筒冠花属 | ['tǒngguānhuā shǔ', 'род сифокранион [i](лат. Siphocranion)[/i]']
Нету слова 光柄筒冠花 | ['_', 'Siphocranion nudipes']
Нету слова 头妇草属 | ['_', 'род Xiphodesma']
Нету слова 马岛头花山柚 | ['_', 'Pentarhopalopilia madagascariensis']
Нету слова 头花山柚 | ['_', 'Pentarhopalopilia umbellulata']
Нету слова 金佛山兰 | ['_', 'Cephalanthera nanchuanica']
Нету слова 红花头蕊兰 | ['hónghuā tóuruǐlán', 'пыльцеголовник красный [i](лат. Cephalanthera rubra)[/i]']
Нету слова 近无叶头蕊兰 | ['_', 'Cephalanthera subaphylla']
Нету слова 云南头蕊兰 | ['_', 'Cephalanthera yuennanensis']
Нету слова 凸轴蕨属 | ['tūzhóujué shǔ', 'род метателиптерис [i](лат. Metathelypteris)[/i]']
Нету слова 三角叶凸轴蕨 | ['_', 'Metathelypteris deltoideofrons']
Нету слова 凸轴蕨 | ['_', 'Metathelypteris gracilescens']
Нету слова 有柄凸轴蕨 | ['_', 'Metathelypteris petiolulata']
Нету слова 西藏凸轴蕨 | ['_', 'Metathelypteris uraiensis var. tibetica']
Нету слова 秃发菊属 | ['_', 'род Piptocoma']
Нету слова 单秃发菊 | ['_', 'Piptocoma acuminata']
Нету слова 秃发菊 | ['_', 'Piptocoma rufescens']
Нету слова 秃穗霉草 | ['_', 'Kihansia lovettii']
Нету слова 短托苔属 | ['duǎntuōtái shǔ', '[ref]突苞苔属[/ref]']
Нету слова 突苞苔 | ['_', 'Exormotheca pustulosa']
Нету слова 狭叶突果苋 | ['xiáyè tūguǒxiàn', 'кифокарпа узколистная [i](лат. Kyphocarpa angustifolia)[/i]']
Нету слова 突蒴藓属 | ['tūshuòxiǎn shǔ', 'род экзертотека [i](лат. Exsertotheca)[/i]']
Нету слова 徒果草属 | ['túguǒcǎo shǔ', 'род бесшипник [i](лат. Anoplocaryum)[/i]']
Нету слова 细弱徒果草 | ['_', 'Anoplocaryum tenellum']
Нету слова 银绒土木香 | ['yínróng tǔmùxiāng', 'девясил белоснежный [i](лат. Inula candida subsp. candida)[/i]']
Нету слова 高山土木香 | ['_', 'Inula mannii']
Нету слова 糙毛旋覆花 | ['cāomáo xuánfùhuā', 'девясил шероховатый [i](лат. Inula aspera)[/i]']
Нету слова 里海旋覆花 | ['lǐhǎi xuánfùhuā', 'девясил каспийский [i](лат. Inula caspica)[/i]']
---------------------
Итого не найдено: 37524
(.venv) PS C:\Users\dns80\Рабочий стол\учёба\4 курс\7 семестр\devOps\ci-cd> diff